Az alább felsoroltak közül melyik nem jellemző a társadalmi és jogi normákra?<br>a) A hipotetikus szerkezet.<br>b) A szankció.<br>c) A múltra irányultság.<br>d) Mindegyik jellemző.	A múltra irányultság.
Az alábbiak közül melyik nem tartozik a társadalmi normák lényeges mozzanatai közé?<br>a) A magatartás leírása.<br>b) A magatartás minősítése. (tilos, kötelező stb.)<br>c) A következmények leírása.<br>d) Mindegyik oda tartozik.	Mindegyik oda tartozik.
Melyik állítás a legjellemzőbb a jogi normákra?<br>a) A társadalom alkotja, érvényesülését az állam biztosítja.<br>b) Az állam alkotja, érvényesülését az állam biztosítja.<br>c) Az állam alkotja, érvényesülését a társadalom biztosítja.<br>d) A társadalom alkotja, érvényesülését a társadalom biztosítja.	Az állam alkotja, érvényesülését az állam biztosítja.
Az alábbi 3 állítás közül melyik hamis?<br>a) A jogi normákat gyorsabban meg lehet változtatni, mint az erkölcsi normákat.<br>b) Az erkölcsi normák szankciórendszerét a társadalmi nyomás jellemzi.<br>c) A jogi norma az emberek formális magatartására irányul.<br>d) Mindhárom előző állítás igaz.	Mindhárom előző állítás igaz.
Az alábbi 3 állítás közül melyik hamis?<br>a) Az erkölcsi normákat gyorsabban meg lehet változtatni, mint a jogi normákat.<br>b) Az erkölcsi normák szankciórendszerét a társadalmi nyomás jellemzi.<br>c) A jogi norma az emberek formális magatartására irányul.<br>d) Mindhárom előző állítás igaz.	Az erkölcsi normákat gyorsabban meg lehet változtatni, mint a jogi normákat.
Hányféle módját ismerjük a jogképződésnek, a jogi normák létrejöttének? Sorolja is fel ezeket.<br>a) 2 jogalkalmazói (bírói), jogalkotói<br>b) 3 szokásjogi, jogalkalmazói (bírói), jogalkotói<br>c) 4 szokásjogi, vallásjogi, jogalkalmazói (bírói), jogalkotói<br>d) 5 szokásjogi, vallásjogi, jogalkalmazói (bírói), jogalkotói, jogtudományi	3 szokásjogi, jogalkalmazói (bírói), jogalkotói
Melyik jogképződési mód során jön létre a precedensjog?<br>a) Szokásjogi jogképződés útján.<br>b) Jogalkalmazói jogképződés útján.<br>c) Jogalkotói jogképződés útján.<br>d) Megyegyezés útján.	Jogalkalmazói jogképződés útján.
A jog melyik funkciójának megvalósítását biztosítja elsősorban a bírósági szervezet?<br>a) Az integráló funkciót.<br>b) A konfliktus-feloldó funkciót.<br>c) A társadalomszervező funkciót.<br>d) Egyik funkció megvalósítását sem biztosítja.	A konfliktus-feloldó funkciót.
A jog melyik funkciójának megvalósítását biztosítják elsősorban a közigazgatási hatóságok?<br>a) Az integráló funkciót.<br>b) A konfliktus-feloldó funkciót.<br>c) A társadalomszervező funkciót.<br>d) Egyik funkció megvalósítását sem biztosítják.	A társadalomszervező funkciót.
Az alábbi 3 állítás közül melyik hamis?<br>a) Az anyagi jogforrás azt a szervet jelenti, amelytől a jogi norma ered.<br>b) Az alaki jogforrás azt a formát jelenti, amelyben a jogi norma megjelenik.<br>c) Elsődleges jogforrás maga a jogalkotó hatalom, az állam.<br>d) Mindhárom előző állítás igaz.	Mindhárom előző állítás igaz.
Mit mond ki a "Lex superior derogat legi inferiori" alapelv?<br>a) A később megalkotott jogszabály a korábbinak a hatályát lerontja.<br>b) A speciális jogszabályt kell alkalmazni az általánossal szemben.<br>c) Alacsonyabb szintű jogszabály nem ellenkezhet magasabb szintűvel.<br>d) Jogszabállyal ellentétes másik jogszabályt nem lehet alkotni.	Alacsonyabb szintű jogszabály nem ellenkezhet magasabb szintűvel.
Mit mond ki a "Lex posterior derogat legi priori" alapelv?<br>a) A később megalkotott jogszabály a korábbinak a hatályát lerontja.<br>b) A speciális jogszabályt kell alkalmazni az általánossal szemben.<br>c) Alacsonyabb szintű jogszabály nem ellenkezhet magasabb szintűvel.<br>d) Jogszabállyal ellentétes másik jogszabályt nem lehet alkotni.	A később megalkotott jogszabály a korábbinak a hatályát lerontja.
Mit mond ki a "Lex specialis derogat legi generali" alapelv?<br>a) A később megalkotott jogszabály a korábbinak a hatályát lerontja.<br>b) A speciális jogszabályt kell alkalmazni az általánossal szemben.<br>c) Alacsonyabb szintű jogszabály nem ellenkezhet magasabb szintűvel.<br>d) Jogszabállyal ellentétes másik jogszabályt nem lehet alkotni.	A speciális jogszabályt kell alkalmazni az általánossal szemben.
Az alábbi jogszabályok közül melyik tartozik az anyagi jog körébe?<br>a) A büntetőeljárásról szóló törvény.<br>b) A polgári eljárásról szóló törvény.<br>c) Az általános közigazgatási rendtartásról szóló törvény.<br>d) Egyik sem.	Egyik sem.
Az alábbi jogszabályok közül melyik tartozik az anyagi jog körébe?<br>a) A büntetőeljárásról szóló törvény.<br>b) A polgári törvénykönyv.<br>c) Az általános közigazgatási rendtartásról szóló törvény.<br>d) Egyik sem.	A polgári törvénykönyv.
Az alábbi jogszabályok közül melyik tartozik az alaki jog körébe?<br>a) A büntető törvénykönyv.<br>b) A büntetőeljárásról szóló törvény.<br>c) A polgári törvénykönyv.<br>d) A munka törvénykönyve.	A büntetőeljárásról szóló törvény.
Melyik állítás igaz?<br>a) A polgári jog a közjog területéhez tartozik.<br>b) A büntetőjog a magánjog területéhez tartozik.<br>c) A kereskedelmi jog a magánjog területéhez tartozik.<br>d) A közigazgatási jog a magánjog területéhez tartozik.	A kereskedelmi jog a magánjog területéhez tartozik.
Mit nevezünk joghézagnak?<br>a) Amikor a bíróság nem tud választani két alkalmazandó jogszabály közül.<br>b) Amikor két jogszabály egymásnak ellentmondó.<br>c) Amikor a jog nem tartalmaz választ egy adott kérdésre.<br>d) Amikor nincs olyan bíróság, amelyik dönthetne egy adott kérdésben.	Amikor a jog nem tartalmaz választ egy adott kérdésre.
Melyik jogág szabályozási körébe tartozik a gyülekezési jog?<br>a) Polgári jog.<br>b) Alkotmányjog.<br>c) Munkajog.<br>d) Közigazgatási jog.	Alkotmányjog.
Melyik állítás igaz az angolszász jogrendszerekre?<br>a) A jogalkotás és jogalkalmazás szférája mereven elválik egymástól.<br>b) A szabályok jelentős része nincs törvénybe foglalva.<br>c) E jogrendszerek pillérei az írott jogforrások.<br>d) A joganyag önálló, zárt rendszert alkot.	A szabályok jelentős része nincs törvénybe foglalva.
Melyik jogrendszerre a leginkább jellemző, hogy politikailag erősen kötött?<br>a) Az angolszász jogrendszerekre.<br>b) A szocialista jogrendszerekre.<br>c) A kontinentális jogrendszerekre.<br>d) A vallási alapú jogrendszerekre.	A szocialista jogrendszerekre.
Melyik állítás igaz a kontinentális jogrendszerekre?<br>a) A bírónak jelentős szerepe van a jogalkotásban.<br>b) A jogszabályok kevésbé elvontak és általánosak.<br>c) A joganyag önálló, zárt rendszert alkot.<br>d) A jogszabályok egy-egy vitás ügy eldöntésekor keletkeznek.	A joganyag önálló, zárt rendszert alkot.
Melyik állítás nem igaz a szocialista jogrendszerekre vonatkozóan?<br>a) A politika közvetlenül befolyásolja a jogot.<br>b) A magánjognak kisebb a jelentősége.<br>c) A jogi túlszabályozás jellemző.<br>d) Mindegyik fenti állítás igaz rá.	Mindegyik fenti állítás igaz rá.
Melyik állítás nem igaz a szocialista jogrendszerekre vonatkozóan?<br>a) A politika közvetlenül befolyásolja a jogot.<br>b) A magánjognak nagy jelentősége van.<br>c) A jogi túlszabályozás jellemző.<br>d) Mindegyik fenti állítás igaz rá.	A magánjognak nagy jelentősége van.
A tényeknek olyan összessége, amelyhez valamilyen joghatás fűződik, ...<br>a) a jogi norma diszpozíciója.<br>b) a jogi norma szankciója.<br>c) a jogi norma hipotézise.<br>d) a jogi norma jogkövetkezménye.	a jogi norma hipotézise.
Az a magatartási szabály, amelyet a jogalkotó a jogalany számára előír, ...<br>a) a jogi norma diszpozíciója.<br>b) a jogi norma szankciója.<br>c) a jogi norma hipotézise.<br>d) a jogi norma jogkövetkezménye.	a jogi norma diszpozíciója.
Egészítse ki a kipontozott részt. A ... esetén a jogalkotó nem határozza meg, hogy mely tényállás esetén szükséges a normában meghatározott magatartást tanúsítani, csupán példaszerűen felsorolja azokat.<br>a) zárt tényállás<br>b) nyitott tényállás<br>c) parancsoló norma<br>d) diszpozitív norma	nyitott tényállás
Milyenfajta rendelkezés nem fordulhat elő a jogi norma diszpozíciójában?<br>a) tiltó<br>b) parancsoló<br>c) megengedő<br>d) mindhárom előfordulhat	mindhárom előfordulhat
Melyik állítás igaz?<br>a) A lopás bűncselekménye mindig vagyoni jellegű szankciót von maga után.<br>b) A jogi norma megsértése nem járhat személyi jellegű szankcióval.<br>c) A szankció egyidejűleg mindig csak egyféle joghátrányt alkalmazhat.<br>d) Az érvénytelenség a szankciók egyik típusa.	Az érvénytelenség a szankciók egyik típusa.
Melyik állítás igaz?<br>a) Az apaság vélelme nem megdönthető.<br>b) A fikció esetén lehetőség van az ellenkező bizonyítására.<br>c) A 14. életévét be nem töltött személy cselekvőképtelenségének vélelme megdönthető.<br>d) A vélelem legfontosabb jogi következménye a bizonyítási teher megfordítása.	A vélelem legfontosabb jogi következménye a bizonyítási teher megfordítása.
Melyik állítás igaz?<br>a) Az apaság vélelme megdönthető.<br>b) A fikció esetén lehetőség van az ellenkező bizonyítására.<br>c) A 14. életévét be nem töltött személy cselekvőképtelenségének vélelme megdönthető.<br>d) A fikció legfontosabb jogi következménye a bizonyítási teher megfordítása.	Az apaság vélelme megdönthető.
Egy jogszabály érvényességének hány feltétele van? Sorolja is fel ezeket.<br>a) 3, a következők: megfelelő szerv; megfelelő eljárás; kihirdetés;<br>b) 4, a következők: megfelelő szerv; megfelelő eljárás; kihirdetés; hierarchiába illeszkedés<br>c) 2, a következők: megfelelő eljárás; kihirdetés<br>d) 5, a következők: megfelelő szerv; megfelelő eljárás; kihirdetés; hierarchiába illeszkedés; nemzetközi jóváhagyás	4, a következők: megfelelő szerv; megfelelő eljárás; kihirdetés; hierarchiába illeszkedés
Melyik állítás igaz?<br>a) A jogszabály időbeli hatálya nem lehet visszamenőleges.<br>b) A magyar jogszabályok területi hatálya Magyarország teljes területe.<br>c) Egy jogszabály lehet egyidejűleg érvényes, de nem hatályos.<br>d) Egy jogszabály lehet egyidejűleg hatályos és érvénytelen.	Egy jogszabály lehet egyidejűleg érvényes, de nem hatályos.
Melyik állítás igaz?<br>a) Egy magyar jogszabály minden magyar állampolgárra vonatkozik.<br>b) Egy jogszabály csak a jövőre vonatkozóan állapíthat meg kötelezettséget.<br>c) A személyi hatály azt határozza meg, hogy ki alkotta a jogszabályt.<br>d) Egy magyar jogszabály csak magyar állampolgárokra vonatkozik.	Egy jogszabály csak a jövőre vonatkozóan állapíthat meg kötelezettséget.
Melyik állítás igaz?<br>a) Egy jogszabály nem érvényes, ha a köztársasági elnök nem írta alá.<br>b) Egy törvény nem érvényes, ha ellenkezik egy rendelettel.<br>c) Egy jogszabály nem érvényes, ha nem hirdették ki.<br>d) Mindhárom fenti állítás hamis.	Egy jogszabály nem érvényes, ha nem hirdették ki.
Melyik állítás igaz?<br>a) Egy jogszabály nem érvényes, ha a köztársasági elnök nem írta alá.<br>b) Egy rendelet nem érvényes, ha ellenkezik egy törvénnyel.<br>c) Egy jogszabály akkor is érvényes, ha nem hirdették ki.<br>d) Mindhárom fenti állítás hamis.	Egy rendelet nem érvényes, ha ellenkezik egy törvénnyel.
Melyik állítás igaz?<br>a) A jogszabályok tudományos értelmezésének csak az adott ügyben van kötelező ereje.<br>b) A jogalkotói jogszabály értelmezés minden címzettre nézve kötelező.<br>c) A jogalkalmazói jogszabály értelmezésnek nincs kötelező ereje.<br>d) A jogalkotói jogszabály értelmezés tilos.	A jogalkotói jogszabály értelmezés minden címzettre nézve kötelező.
Melyik állítás igaz?<br>a) A közigazgatási szervek eljárása mindig kezdeményezésre indul.<br>b) A jogalanyok önkéntes jogkövetését is jogalkalmazásnak tekintjük.<br>c) A jogalkalmazás célja mindig valamilyen jogsérelem orvoslása.<br>d) A jogalkalmazás utolsó lépése a tényállás megállapítása.	A jogalanyok önkéntes jogkövetését is jogalkalmazásnak tekintjük.
Melyik nem következhet be a jogalkalmazás eredményeképpen?<br>a) Jogviszony keletkezése.<br>b) Jogviszony megszűnése.<br>c) Jogviszony módosulása.<br>d) Mindhárom fenti bekövetkezhet.	Mindhárom fenti bekövetkezhet.
Mely szerv biztosítja a bíróságok egységes jogalkalmazását?<br>a) Az alkotmánybíróság.<br>b) A törvényszék.<br>c) Az ítélőtábla.<br>d) A Kúria.	A Kúria.
Mely szerv biztosítja a bíróságok egységes jogalkalmazását?<br>a) Az alkotmánybíróság.<br>b) Az ítélőtábla.<br>c) A Kúria.<br>d) Egyik sem.	A Kúria.
Melyik nem tartozik a jogszabály értelmezésének módszerei közé?<br>a) A rendszertani értelmezés.<br>b) A történeti értelmezés.<br>c) A módszertani értelmezés.<br>d) A logikai értelmezés.	A módszertani értelmezés.
A jogviszony szerkezeti elemei közé tartozik<br>a) a jogviszony helye.<br>b) a jogviszony ideje.<br>c) a jogviszony tartalma.<br>d) Egyik sem.	a jogviszony tartalma.
Ingatlan adásvételi szerződés esetén a jogviszony tárgya<br>a) a vételár kifizetése.<br>b) a tulajdonjog átruházása.<br>c) az ingatlan.<br>d) Egyik sem.	az ingatlan.
Melyik állítás hamis?<br>a) A kötelmi jogban a relatív szerkezetű jogviszonyok jellemzők.<br>b) A tulajdonjog abszolút szerkezetű jogviszony.<br>c) Ha több, mint 2 fél szerepel a szerződésben, az abszolút szerkezetű jogviszonyt eredményez.<br>d) A károkozás relatív szerkezetű jogviszonyt teremt.	Ha több, mint 2 fél szerepel a szerződésben, az abszolút szerkezetű jogviszonyt eredményez.
Az alábbiak közül melyik nem rendelkezik jogi személyiséggel?<br>a) Az Állam.<br>b) Az egyesület.<br>c) A társasház.<br>d) Mindegyik rendelkezik.	A társasház.
Az alábbiak (a,b,c) közül melyik nem rendelkezik jogi személyiséggel?<br>a) Az Állam.<br>b) Az egyesület.<br>c) Az egyetem.<br>d) Mindegyik rendelkezik. 	Mindegyik rendelkezik. 
Melyik állítás igaz?<br>a) Együttes kötelezettek bármelyikétől az egész tartozás követelhető.<br>b) Egyetemleges kötelezettek egyidejűleg, de arányosan kötelesek teljesíteni.<br>c) A kezes az adóssal fele-fele arányban köteles teljesíteni a tartozást.<br>d) Mindhárom fenti állítás hamis.	Mindhárom fenti állítás hamis.
Az alábbi 3 állítás közül melyik hamis?<br>a) Aki jogképes, az önállóan köthet szerződést.<br>b) Aki jogképes, az jogosultságok alanya lehet.<br>c) Aki betöltötte a 14. életévét az jogképes.<br>d) Mindhárom előző állítás igaz.	Aki jogképes, az önállóan köthet szerződést.
Melyik állítás igaz?<br>a) A jogképesség a születéssel kezdődik.<br>b) A jogképesség mindig a születés előtti 300-adik napon kezdődik.<br>c) A jogképesség mindig a fogamzástól kezdődik.<br>d) A magzat jogképessége feltételes.	A magzat jogképessége feltételes.
Melyik állítás igaz?<br>a) A bíróság korlátozhatja a természetes személy jogképességét.<br>b) A Ptk. nem korlátozhatja az ember cselekvőképességét.<br>c) Aki cselekvőképes, az önállóan köthet szerződést.<br>d) Mindhárom fenti állítás hamis.	Aki cselekvőképes, az önállóan köthet szerződést.
Az alábbi 3 állítás közül melyik hamis?<br>a) 17 éves személy is lehet nagykorú.<br>b) 17 éves személy is lehet cselekvőképes.<br>c) 13 éves személy is lehet korlátozottan cselekvőképes.<br>d) Mindhárom előző állítás igaz.	13 éves személy is lehet korlátozottan cselekvőképes.
Az alábbi 3 állítás közül melyik hamis?<br>a) A kiskorú személy a házasságkötéssel nagykorúvá válik.<br>b) 17 éves személy is lehet cselekvőképes.<br>c) A 13 éves személy minden esetben cselekvőképtelennek minősül.<br>d) Mindhárom előző állítás igaz.	Mindhárom előző állítás igaz.
Az alábbi 3 állítás közül melyik hamis?<br>a) Nagykorú személy is lehet cselekvőképtelen.<br>b) Kiskorú személy is lehet korlátozottan cselekvőképes.<br>c) A kiskorú személy házasságkötése minden esetben érvénytelen.<br>d) Mindhárom előző állítás igaz.	A kiskorú személy házasságkötése minden esetben érvénytelen.
Mit nem tehet meg önállóan a korlátozottan cselekvőképes kiskorú?<br>a) Tetszőleges értékű ajándékot adhat.<br>b) Tetszőleges értékű ajándékot elfogadhat.<br>c) Rendelkezhet munkával szerzett jövedelmével.<br>d) Mindhárom fenti jognyilatkozatot megteheti önállóan.	Tetszőleges értékű ajándékot adhat.
Melyik nem tartozik a gyám feladatai közé?<br>a) A gyermek gondozása, nevelése.<br>b) A gyermek vagyonának kezelése.<br>c) A gyermek törvényes képviselete.<br>d) Mindhárom fenti a gyám feladatai közé tartozik.	Mindhárom fenti a gyám feladatai közé tartozik.
Melyikkel nem feltétlenül kell rendelkeznie a jogi személynek?<br>a) Székhellyel.<br>b) Saját vagyonnal.<br>c) Telephellyel.<br>d) Képviselővel.	Telephellyel.
Ki felel a jogi személy tartozásaiért?<br>a) A vezető tisztségviselő.<br>b) A döntéshozó szerv.<br>c) A tagok és alapítók.<br>d) Egyik sem.	Egyik sem.
Mikor jön létre a jogi személy?<br>a) A létesítő okirat aláírásakor.<br>b) A bejegyzési kérelem bírósághoz történő benyújtásakor.<br>c) A bírósági nyilvántartásba vétel megtörténtekor.<br>d) A bírósági határozat kézbesítésekor.	A bírósági nyilvántartásba vétel megtörténtekor.
Ki látja el a jogi személy tulajdonosainak érdekvédelmét?<br>a) A könyvvizsgáló.<br>b) A vezető tisztségviselő.<br>c) A felügyelőbizottság.<br>d) Egyik sem.	A felügyelőbizottság.
Ki látja el a jogi személy törvényes működésének felügyeletét?<br>a) Az ügyészség.<br>b) A felügyelőbizottság.<br>c) A nyilvántartó bíróság.<br>d) Egyik sem.	A nyilvántartó bíróság.
Melyik állítás hamis?<br>a) Összeolvadásnál a korábbi jogi személyek megszűnnek.<br>b) Kiválásnál a jogi személy megszűnik.<br>c) Különválásnál a jogi személy megszűnik.<br>d) Átalakulásnál a korábbi jogi személy megszűnik.	Kiválásnál a jogi személy megszűnik.
Melyik nem tartozik a (jogi személy) jogutód nélküli megszűnés esetei közé?<br>a) A tagok kimondják a megszűnést.<br>b) A létesítő okiratban meghatározott idő eltelik.<br>c) A jogi személy tartozása meghaladja a vagyonát.<br>d) A jogosult szerv megszünteti.	A jogi személy tartozása meghaladja a vagyonát.
Melyik állítás igaz?<br>a) Alapítvány létrehozásához legalább 10 alapító szükséges.<br>b) Az egyesület megszűnik, ha tagjainak száma tartósan nem éri el a 12 főt.<br>c) Az egyesület átalakulhat alapítvánnyá.<br>d) Egyik fenti állítás sem igaz.	Egyik fenti állítás sem igaz.
Melyik állítás igaz?<br>a) Alapítvány létrehozásához legalább 10 alapító szükséges.<br>b) Az egyesület megszűnik, ha tagjainak száma tartósan nem éri el a 10 főt.<br>c) Az alapítvány átalakulhat egyesületté.<br>d) Egyik fenti állítás sem igaz.	Az egyesület megszűnik, ha tagjainak száma tartósan nem éri el a 10 főt.
Egyesületnél mely esetben kötelező a felügyelőbizottság létrehozása?<br>a) Ha a tagok több, mint negyede nem természetes személy.<br>b) Ha a tagok létszáma az 50 főt meghaladja.<br>c) Ha a könyvvizsgáló ezt kéri.<br>d) Egyik fenti esetben sem kötelező.	Egyik fenti esetben sem kötelező.
Egyesületnél mely esetben kötelező a felügyelőbizottság létrehozása?<br>a) Ha a tagok több, mint fele nem természetes személy.<br>b) Ha a tagok létszáma az 50 főt meghaladja.<br>c) Ha a könyvvizsgáló ezt kéri.<br>d) Egyik fenti esetben sem kötelező.	Ha a tagok több, mint fele nem természetes személy.
Melyik állítás igaz?<br>a) Alapítvány nem, de egyesület létrehozható gazdasági tevékenység folytatására.<br>b) Egyesület nem, de alapítvány létrehozható gazdasági tevékenység folytatására.<br>c) Sem egyesület, sem alapítvány nem hozható létre gazdasági tevékenység folytatására.<br>d) Egyesület és alapítvány is létrehozható gazdasági tevékenység folytatására.	Sem egyesület, sem alapítvány nem hozható létre gazdasági tevékenység folytatására.
Melyik jellemző a kontinentális (német) társasági modellre?<br>a) Erősen megosztott a tulajdonosi szerkezet.<br>b) Csekély a társasági formaválaszték.<br>c) A társasági szervek élesen elkülönülnek egymástól.<br>d) Egyik sem jellemző.	A társasági szervek élesen elkülönülnek egymástól.
Melyik nem jellemző az angol-amerikai társasági modellre?<br>a) A társasági jog szorosan összefonódik a tőkepiac intézményeivel.<br>b) A társaságnak egységes vezető szerve van.<br>c) A könyvvizsgáló szerepe és felelőssége csekély.<br>d) Mindegyik fenti állítás jellemző rá.	A könyvvizsgáló szerepe és felelőssége csekély.
Az alábbiak közül melyik szolgálja a közérdeket a társasági jogban?<br>a) A diszpozitív szabályozás.<br>b) A cégnyilvánosság elve.<br>c) A választott bírósági eljárás igénybevételének lehetősége.<br>d) Egyik sem.	A cégnyilvánosság elve.
Melyik társasági forma nem hozható létre egyszemélyes gazdasági társaságként?<br>a) Egyszemélyes korlátolt felelősségű társaság.<br>b) Egyszemélyes betéti társaság.<br>c) Egyszemélyes részvénytársaság.<br>d) Mindhárom forma létrehozható.	Egyszemélyes betéti társaság.
Melyik társasági forma hozható létre egyszemélyes gazdasági társaságként?<br>a) Egyszemélyes betéti társaság.<br>b) Egyszemélyes korlátolt felelősségű társaság.<br>c) Egyszemélyes közkereseti társaság.<br>d) Egyik sem hozható létre.	Egyszemélyes korlátolt felelősségű társaság.
Hány tag alapíthat közkereseti társaságot?<br>a) Legalább egy beltag.<br>b) Legalább egy beltag és egy kültag.<br>c) Legalább két tag.<br>d) Legalább két beltag.	Legalább két tag.
Milyen célt szolgál a társasági formakényszer?<br>a) A hitelezők védelmét.<br>b) A kisebbségi jogok védelmét.<br>c) A társulási szabadság érvényre jutását.<br>d) A közérdeket.	A közérdeket.
Hányféle társasági formában alapítható gazdasági társaság? Sorolja is fel őket.<br>a) 3, a következők: Bt., Kft., Zrt.<br>b) 4, a következők: Kkt., Bt., Kft., Zrt.<br>c) 5, a következők: Kkt., Bt., Kft., Zrt., Nyrt.<br>d) Egyik fenti válasz sem megfelelő	4, a következők: Kkt., Bt., Kft., Zrt.
Az alábbiak közül melyik szervezet nem rendelkezik jogi személyiséggel?<br>a) A korlátolt felelősségű társaság.<br>b) A betéti társaság.<br>c) A részvénytársaság.<br>d) Mindegyik rendelkezik.	Mindegyik rendelkezik.
Az alábbiak közül melyik szervezet nem rendelkezik jogi személyiséggel?<br>a) A korlátolt felelősségű társaság.<br>b) Az egyéni cég.<br>c) A részvénytársaság.<br>d) Mindegyik rendelkezik.	Az egyéni cég.
Az alábbiak közül melyik nem lehet apport gazdasági társaság alapítása során?<br>a) Egy személyautó.<br>b) Egy találmány.<br>c) Szerződésen alapuló követelés.<br>d) A fentiek mindegyike lehet apport.	Szerződésen alapuló követelés.
Melyik állítás igaz?<br>a) Közkereseti társaság nem lehet egy korlátolt felelősségű társaságnak tagja.<br>b) Betéti társaság nem lehet egy közkereseti társaságnak tagja.<br>c) Korlátolt felelősségű társaság nem lehet egy betéti társaságnak beltagja.<br>d) Részvénytársaságnak csak természetes személyek lehetnek a tagjai.	Betéti társaság nem lehet egy közkereseti társaságnak tagja.
Melyiket nem kezdeményezhetik a G.T. szavazati jogok 5%-ával rendelkező tagjai?<br>a) Egyedi könyvvizsgálatot.<br>b) A legfőbb szerv összehívását.<br>c) Egy tag kizárását.<br>d) A társaság igényének érvényesítését egy taggal szemben.	Egy tag kizárását.
Kik szavazhatnak a gazdasági társaság legfőbb szervének ülésén?<br>a) A társaság tagjai.<br>b) A társaság tagjai és a vezető tisztségviselő.<br>c) A tagok és a felügyelő bizottság tagjai.<br>d) A tagok és a cégvezetők.	A társaság tagjai.
Melyik tartozik a gazdasági társaság felügyelőbizottságának feladatai közé?<br>a) A vezető tisztségviselő megválasztása és visszahívása.<br>b) A könyvvizsgáló ellenőrzése.<br>c) Az ügyvezetés ellenőrzése.<br>d) A beszámoló elkészítése.	Az ügyvezetés ellenőrzése.
A gazdasági társaság melyik szerve kezdeményezheti egy tag kizárását?<br>a) A felügyelő bizottság.<br>b) A legfőbb szerv.<br>c) A vezető tisztségviselő.<br>d) Egyik sem, mert tagot nem lehet kizárni.	A legfőbb szerv.
Melyik szerv dönt a társaság jogutód nélküli megszűnéséről?<br>a) A legfőbb szerv.<br>b) A felügyelő bizottság.<br>c) A vezető tisztségviselő.<br>d) A könyvvizsgáló. 	A legfőbb szerv.
Melyik állítás hamis a Kft-re vonatkozóan?<br>a) Kft. esetén a tagok törzsbetétei különböző mértékűek lehetnek.<br>b) Az egyes törzsbetétek mértéke legalább 100.000 Ft.<br>c) A törzstbetétek összege a törzstőke, melynek minimális mértéke 1 millió Ft.<br>d) Egy tagnak több üzletrésze is lehet.	A törzstbetétek összege a törzstőke, melynek minimális mértéke 1 millió Ft.
Melyik állítás hamis?<br>a) A Bt. alaptőkéje nem lehet kevesebb, mint 100.000 Ft.<br>b) A Zrt. alaptőkéje nem lehet kevesebb, mint 5 millió Ft.<br>c) Az Nyrt. alaptőkéje nem lehet kevesebb, mint 20 millió Ft.<br>d) A közkereseti társaság alaptőkéjére nincs minimális előírás.	A Bt. alaptőkéje nem lehet kevesebb, mint 100.000 Ft.
Kinek a tulajdona a betéti társaság vagyona?<br>a) A beltagok közös tulajdona.<br>b) Valamennyi tag közös tulajdona.<br>c) A társaság tulajdona.<br>d) Az alapító tagok közös tulajdona. 	A társaság tulajdona.
Melyik állítás hamis?<br>a) Az egyesülés jogi személyiséggel rendelkezik.<br>b) Az egyesülés vagyonát meghaladó tartozásaiért a tagok nem felelnek.<br>c) Az egyesülés saját nyereségre nem törekszik.<br>d) Az egyesülés célja a tagok tevékenységének összehangolása.	Az egyesülés vagyonát meghaladó tartozásaiért a tagok nem felelnek.
Melyik állítás igaz?<br>a) A szövetkezet tagjainak többsége természetes személy.<br>b) A szövetkezet valamennyi tagjának személyes közreműködést kell vállalnia.<br>c) Szövetkezeti jogvitára választott-bírósági eljárás nem köthető ki.<br>d) A szövetkezet nem rendelkezik jogi személyiséggel.	A szövetkezet tagjainak többsége természetes személy.
Hány személy alapíthat szövetkezetet?<br>a) Legalább 2 személy.<br>b) Legalább 7 személy.<br>c) Legalább 10 személy.<br>d) Egy személy is alapíthat.	Legalább 7 személy.
Melyik állítás hamis?<br>a) A szövetkezet közgyűlésén minden tagnak egy szavazata van.<br>b) Szövetkezetnél kötelező a könyvvizsgáló kinevezése.<br>c) Szövetkezetnél kötelező a felügyelőbizottság működése.<br>d) A szövetkezet ügyvezetését az igazgatóság látja el.	Szövetkezetnél kötelező a könyvvizsgáló kinevezése.
Melyik szervezet nem vehet részt tagként vállalatcsoportban?<br>a) Korlátolt felelősségű társaság.<br>b) Szövetkezet.<br>c) Egyesülés.<br>d) Betéti társaság.	Betéti társaság.
Melyik állítás hamis a vállalatcsoportra vonatkozóan?<br>a) Legalább egy uralkodó tag és 3 ellenőrzött tag szükséges hozzá.<br>b) A cégbíróság a cégnyilvántartásba bejegyzi.<br>c) Az uralkodó tag nem utasíthatja az ellenőrzött tagokat.<br>d) Önálló jogi személyiséggel nem rendelkezik.	Az uralkodó tag nem utasíthatja az ellenőrzött tagokat.
Az alábbiak közül ki nem lehet egyéni vállalkozó?<br>a) 17 éves, házasságot kötött személy.<br>b) Közkereseti társaság tagja.<br>c) Korlátolt felelősségű társaság tagja.<br>d) Betéti társaság kültagja.	Közkereseti társaság tagja.
Melyik szervezet vezeti az egyéni vállalkozók nyilvántartását?<br>a) A Nemzeti Adó és Vámhivatal (NAV).<br>b) A cégbíróság.<br>c) A törvényszék.<br>d) A céginformációs szolgálat.	A Nemzeti Adó és Vámhivatal (NAV).
Melyik állítás igaz?<br>a) Az egyéni vállalkozónak nem lehet alkalmazottja.<br>b) A tevékenység csak egyéni vállalkozói igazolvány kiállítása után végezhető.<br>c) Az egyéni vállalkozó a kötelezettségeiért csak vállalkozói vagyonával felel.<br>d) Az egyéni vállalkozó köteles személyesen közreműködni a tevékenység folytatásában.	Az egyéni vállalkozó köteles személyesen közreműködni a tevékenység folytatásában.
Melyik állítás hamis az egyéni cégre vonatkozóan?<br>a) Az egyéni cég jogképes.<br>b) Az egyéni cég jogi személyiséggel rendelkezik.<br>c) Az egyéni céget a cégbíróság tartja nyilván.<br>d) Az egyéni cégnek cégjegyzékszáma van.	Az egyéni cég jogi személyiséggel rendelkezik.
Ki alapíthat egyéni céget?<br>a) Minden nagykorú, cselekvőképes személy.<br>b) Minden nagykorú, cselekvőképes magyar állampolgár.<br>c) Aki az egyéni vállalkozói nyilvántartásban szerepel.<br>d) Minden nagykorú, cselekvőképes személy, aki nem korlátlanul felelős tagja G.T.-nak.	Aki az egyéni vállalkozói nyilvántartásban szerepel.
Az alábbiak közül melyik nem lehet egy egyéni cég alapításkori jegyzett tőkéje?<br>a) 100.000 Ft plusz egy 200.000 Ft értékű autó.<br>b) 100.000 Ft plusz egy 100.000 Ft értékű autó.<br>c) Egy 300.000 Ft értékű autó. <br>d) 100.000 Ft.	100.000 Ft plusz egy 100.000 Ft értékű autó.
Melyik állítás hamis?<br>a) A köztestület közfeladatot lát el.<br>b) A köztestületet a tagjai szabad elhatározásukkal hozzák létre.<br>c) A köztestület jogi személy.<br>d) A Magyar Orvosi Kamara is egy köztestület.	A köztestületet a tagjai szabad elhatározásukkal hozzák létre.
Az alábbiak közül melyik nem köztestület?<br>a) Magyar Tudományos Akadémia<br>b) Magyar Ügyvédi Kamara<br>c) Magyar Labdarúgó Szövetség<br>d) Mindhárom köztestület	Magyar Labdarúgó Szövetség
Az alábbiak közül melyik nem köztestület?<br>a) Magyar Tudományos Akadémia<br>b) Magyar Ügyvédi Kamara<br>c) Magyar Kereskedelmi és Iparkamara<br>d) Mindhárom köztestület	Mindhárom köztestület
Az alábbiak közül melyik nem lehet közhasznú státuszú?<br>a) A köztestület.<br>b) Az egyesület.<br>c) Az alapítvány.<br>d) A nonprofit Kft.	A köztestület.
Az alábbi jogalanyok közül melyiknek nincs cégjegyzékszáma?<br>a) Az egyesülésnek.<br>b) A szövetkezetnek.<br>c) Az egyesületnek.<br>d) Az egyéni cégnek.	Az egyesületnek.
Az alábbiak közül melyik nem a cégbíróság feladata?<br>a) Cégbejegyzési eljárás lefolytatása.<br>b) Felszámolási eljárás lefolytatása.<br>c) Döntés a közhasznúvá minősítésről.<br>d) Törvényességi felügyeleti eljárás lefolytatása cégekkel kapcsolatban.	Felszámolási eljárás lefolytatása.
Az alábbi esetek közül melyik fordulhat elő egy céggel kapcsolatban?<br>a) Székhelye Vácon van, telephelye nincs, fióktelepe Vácon van.<br>b) Székhelye nincs, telephelye Vácon van, fióktelepe Vácon van.<br>c) Székhelye Vácon van, telephelye Vácon van, fióktelepe nincs.<br>d) Székhelye Vácon van, telephelye Vácon van, fióktelepe Vácon van.	Székhelye Vácon van, telephelye Vácon van, fióktelepe nincs.
Melyik állítás hamis?<br>a) A cégbejegyzési kérelmet csak elektronikus úton lehet benyújtani.<br>b) A cégbejegyzési eljárás nem-peres eljárás. <br>c) A kérelmet a létesítő okirat aláírásától számított 30 napon belül kell benyújtani.<br>d) A cégbejegyzési eljárás során a jogi képviselet nem kötelező.	A cégbejegyzési eljárás során a jogi képviselet nem kötelező.
Ki dönt egy cég esetén a végelszámolásról?<br>a) A cégbíróság.<br>b) A cég legfőbb szerve.<br>c) A vezető tisztségviselő.<br>d) A hitelező(k).	A cég legfőbb szerve.
Mikor van helye egyszerűsített cégbejegyzési eljárásnak?<br>a) Egyéni cég és Bt. alapításakor.<br>b) Ha a cég alaptőkéje nem haladja meg a 100.000 Ft-ot.<br>c) Ha a létesítő okirat szerződésminta alapján készült.<br>d) Ha a tagok száma egy fő.	Ha a létesítő okirat szerződésminta alapján készült.
Mely cégeknek kell bankszámlával rendelkeznie?<br>a) Csak a Zrt.-nek és az Nyrt.-nek.<br>b) A gazdasági társaságoknak.<br>c) A Zrt.-nek, Nyrt.-nek és a Kft.-nek.<br>d) Minden cégnek bankszámlával kell rendelkeznie.	Minden cégnek bankszámlával kell rendelkeznie.
Mennyi egy Zrt. egyszerűsített cégbejegyzési eljárásának illetéke?<br>a) 10.000 Ft<br>b) 50.000 Ft<br>c) 100.000 Ft<br>d) Az eljárás illetékmentes.	50.000 Ft
Mennyi egy Kft. rendes (nem egyszerűsített) cégbejegyzési eljárásának illetéke?<br>a) 10.000 Ft<br>b) 50.000 Ft<br>c) 100.000 Ft<br>d) Az eljárás illetékmentes.	Az eljárás illetékmentes.
Ki képviseli a céget a végelszámolás kezdő időpontja után?<br>a) A vezető tisztségviselő.<br>b) A vagyonfelügyelő.<br>c) A felügyelőbizottság elnöke.<br>d) A végelszámoló.	A végelszámoló.
Melyik eljárásnak nem célja a cég jogutód nélküli megszüntetése?<br>a) A felszámolási eljárásnak.<br>b) A csődeljárásnak.<br>c) A végelszámolásnak.<br>d) Mindegyiknek az a célja.	A csődeljárásnak.
Mi a csődeljárás célja?<br>a) A fizetésképtelen adós cég jogutód nélküli megszüntetése.<br>b) A nem fizetésképtelen cég jogutód nélküli megszüntetése.<br>c) Az adós cég fizetési haladékot kap a hitelezőkkel való megegyezés céljából.<br>d) Az adós cég vagyonának hatósági árverésen való értékesítése.	Az adós cég fizetési haladékot kap a hitelezőkkel való megegyezés céljából.
Mi a végelszámolás célja?<br>a) A fizetésképtelen adós cég jogutód nélküli megszüntetése.<br>b) A nem fizetésképtelen cég jogutód nélküli megszüntetése.<br>c) Az adós cég fizetési haladékot kap a hitelezőkkel való megegyezés céljából.<br>d) Az adós cég vagyonának hatósági árverésen való értékesítése.	A nem fizetésképtelen cég jogutód nélküli megszüntetése.
Mi a felszámolási eljárás célja?<br>a) A fizetésképtelen adós cég jogutód nélküli megszüntetése.<br>b) A nem fizetésképtelen cég jogutód nélküli megszüntetése.<br>c) Az adós cég fizetési haladékot kap a hitelezőkkel való megegyezés céljából.<br>d) Az adós cég vagyonának hatósági árverésen való értékesítése.	A fizetésképtelen adós cég jogutód nélküli megszüntetése.
Melyik eljárás indul meg a cégbírósághoz benyújtott változásbejegyzési kérelemmel?<br>a) Csődeljárás.<br>b) Végelszámolás.<br>c) Felszámolási eljárás.<br>d) A fentiek közül egyik sem.	Végelszámolás.
Melyik eljárást indíthatja meg a hitelező az adós cég ellen?<br>a) A végelszámolást.<br>b) A csődeljárást.<br>c) A felszámolási eljárást.<br>d) Kényszer-törlési eljárást.	A felszámolási eljárást.
Melyik eljárást milyen fórumon kell megindítani? Válassza ki a helyeset.<br>a) Csődeljárást a cégbíróságon.<br>b) Felszámolási eljárást a rendes bíróságon (törvényszéken).<br>c) Végelszámolást a rendes bíróságon (törvényszéken).<br>d) Cégbejegyzési eljárást a rendes bíróságon (törvényszéken).	Felszámolási eljárást a rendes bíróságon (törvényszéken).
Kivel szemben nem illeti meg a birtokvédelem joga a birtokost?<br>a) A tulajdonossal szemben.<br>b) A hitelezővel szemben.<br>c) Azzal szemben, akitől a dolgot tilos önhatalommal szerezte meg.<br>d) Kivétel nélkül mindenkivel szemben megilleti.	Azzal szemben, akitől a dolgot tilos önhatalommal szerezte meg.
Melyek a birtokvédelem megengedett eszközei?<br>a) Minden esetben a bírósághoz kell fordulni.<br>b) Minden esetben a jegyzőhöz kell fordulni.<br>c) Minden esetben a rendőrséghez kell fordulni.<br>d) Bírósághoz vagy jegyzőhöz fordulás, speciális esetben önhatalommal való fellépés.	Bírósághoz vagy jegyzőhöz fordulás, speciális esetben önhatalommal való fellépés.
Az alábbiak közül melyik nem tartozik a "szükséges költségek" körébe?<br>a) Az állagmegóvásra fordított költségek.<br>b) A kártól való megóvásra fordított költségek.<br>c) A dolog értékét növelő költségek.<br>d) Mindhárom fenti a "szükséges" költségek körébe tartozik.	A dolog értékét növelő költségek.
Milyen költségei megtérítését követelheti a rosszhiszemű jogalap nélküli birtokos?<br>a) A dologra fordított szükséges költségei megtérítését.<br>b) A dologra fordított hasznos költségei megtérítését.<br>c) A szükséges és hasznos költségei megtérítését is követelheti.<br>d) Semmilyen költségei megtérítését nem követelheti.	A dologra fordított szükséges költségei megtérítését.
Az alábbiak közül melyik nem lehet tulajdonjog tárgya?<br>a) Az elektromos energia (villamos áram).<br>b) A szellemi alkotás.<br>c) Az állatok.<br>d) Az értékpapír.	A szellemi alkotás.
Az alábbi 3 állítás közül melyik hamis?<br>a) Az ingatlan tulajdonosa a használat jogát másnak átengedheti.<br>b) Az ingatlan tulajdonosa a tulajdonjogát másra átruházhatja.<br>c) Az ingatlan tulajdonosa a tulajdonjogával felhagyhat.<br>d) Mindhárom előző állítás igaz.	Az ingatlan tulajdonosa a tulajdonjogával felhagyhat.
Melyik állítás igaz?<br>a) Szükséghelyzetben okozott kár esetén a (károsult) tulajdonos kártérítést követelhet.<br>b) Közérdekű használat esetén a tulajdonost kártérítés illeti meg.<br>c) Kisajátítás esetén a tulajdonost kártérítés illeti meg.<br>d) Mindhárom fenti esetben kártalanítás és nem kártérítés illeti meg a tulajdonost.	Mindhárom fenti esetben kártalanítás és nem kártérítés illeti meg a tulajdonost.
Melyik állítás igaz?<br>a) Jogellenes károkozás esetén a (károsult) tulajdonos kártérítést követelhet.<br>b) Közérdekű használat esetén a tulajdonost kártérítés illeti meg.<br>c) Kisajátítás esetén a tulajdonost kártérítés illeti meg.<br>d) Mindhárom fenti esetben kártalanítás és nem kártérítés illeti meg a tulajdonost.	Jogellenes károkozás esetén a (károsult) tulajdonos kártérítést követelhet.
Az alábbiak közül melyik tulajdonszerzési mód származékos?<br>a) Tulajdon átruházás.<br>b) Hatósági árverés útján való tulajdonszerzés.<br>c) Elbirtoklás.<br>d) Kisajátítás.	Tulajdon átruházás.
Mikor száll át az ingatlan tulajdonjoga átruházás esetén?<br>a) A szerződés megkötésekor.<br>b) A felek által a szerződésben meghatározott időpontban.<br>c) A birtokbaadáskor.<br>d) Az új tulajdonosnak az ingatlan-nyilvántartásba való bejegyzésével.	Az új tulajdonosnak az ingatlan-nyilvántartásba való bejegyzésével.
Melyik állítás hamis?<br>a) Kisajátítás csak közérdekű célra lehetséges.<br>b) Kisajátítani csak ingatlant lehet.<br>c) A kisajátítást csak az állam kérheti.<br>d) A kisajátítási eljárás során a kisajátítási hatóság tárgyalást tart.	A kisajátítást csak az állam kérheti.
Melyik állítás igaz?<br>a) Az ingatlan elbirtoklási ideje 10 év.<br>b) Bűncselekménnyel megszerzett dolgon nem következik be az elbirtoklás.<br>c) Ingatlan elbirtoklásához a tulajdonjogot az ingatlan-nyilvántartásba be kell jegyezni.<br>d) Elbirtoklással csak ingó dolog tulajdonjogát lehet megszerezni.	Bűncselekménnyel megszerzett dolgon nem következik be az elbirtoklás.
Melyik állítás hamis?<br>a) Villamoson felejtett dolgon nem lehet találással tulajdont szerezni.<br>b) Gazdátlan dolgon nem lehet találással tulajdont szerezni.<br>c) A találó csak akkor válik tulajdonossá, ha a korábbi tulajdonos 1 éven belül nem jelentkezik.<br>d) A találás származékos tulajdonszerzési mód.	A találás származékos tulajdonszerzési mód.
Melyik állítás hamis a zálogjogviszony esetén?<br>a) A jogviszony alanya a személyes kötelezett és a zálogjogosult.<br>b) A zálogtárgy tulajdonosa a zálogkötelezett.<br>c) A zálogjogosult kielégítési joga akkor nyílik meg, ha a személyes kötelezett nem teljesít. <br>d) A zálogkötelezett csak a zálogtárggyal felel a zálogjogosultnak. 	A jogviszony alanya a személyes kötelezett és a zálogjogosult.
Melyik állítás hamis a zálogjogviszony esetén?<br>a) A jogviszony alanya a zálogkötelezett és a zálogjogosult.<br>b) A zálogtárgy tulajdonosa a zálogjogosult.<br>c) A zálogjogosult kielégítési joga akkor nyílik meg, ha a személyes kötelezett nem teljesít. <br>d) A zálogkötelezett csak a zálogtárggyal felel a zálogjogosultnak. 	A zálogtárgy tulajdonosa a zálogjogosult.
Melyik állítás hamis a zálogjogviszony esetén?<br>a) A jogviszony alanya a zálogkötelezett és a zálogjogosult.<br>b) A zálogtárgy tulajdonosa a zálogkötelezett.<br>c) A zálogjogosult kielégítési joga akkor nyílik meg, ha a személyes kötelezett nem teljesít. <br>d) A zálogkötelezett teljes vagyonával felel a zálogjogosultnak. 	A zálogkötelezett teljes vagyonával felel a zálogjogosultnak. 
Melyik állítás hamis a zálogjogviszony esetén?<br>a) Az óvadék is a zálog egy fajtája.<br>b) Jelzálogjog csak ingatlanon alapítható.<br>c) Kézizálogjog tárgya csak ingó dolog lehet.<br>d) A személyes kötelezett és a zálogkötelezett lehet ugyanaz a személy.	Jelzálogjog csak ingatlanon alapítható.
Melyiket nem teheti meg a haszonélvezeti jog jogosultja?<br>a) A dolgot nem hasznosíthatja.<br>b) A haszonélvezeti jogot nem ruházhatja át.<br>c) A dolgot nem tarthatja a birtokában.<br>d) A fenti 3 mindegyikét megteheti.	A haszonélvezeti jogot nem ruházhatja át.
Az alábbi esetek közül melyikben nem használhatja a birtokos a dolgot?<br>a) Haszonkölcsön esetén.<br>b) Kézizálog esetén.<br>c) Haszonélvezeti jog esetén.<br>d) A fenti esetek mindegyikében használhatja.	Kézizálog esetén.
Az alábbiak közül melyik magatartásra nem irányulhat a kötelem?<br>a) Valaminek az adására.<br>b) Valamilyen tevékenység elvégzésére.<br>c) Valamitől való tartózkodásra.<br>d) Mindegyik fenti magatartásra irányulhat.	Mindegyik fenti magatartásra irányulhat.
Az alábbiak közül melyikből nem keletkezhet kötelem?<br>a) Jogalap nélküli gazdagodásból.<br>b) Személyiségi jog megsértéséből.<br>c) Utaló magatartásból.<br>d) A fentiek mindegyikéből keletkezhet.	A fentiek mindegyikéből keletkezhet.
Az alábbiak közül melyik károkozás jogellenes?<br>a) A károsult beleegyezésével okozott kár.<br>b) Jogtalan támadás elhárítása során a támadónak okozott kár.<br>c) Szükséghelyzetben okozott kár.<br>d) A fentiek egyike sem jogellenes.	A fentiek egyike sem jogellenes.
Az alábbiak közül melyik esetben keletkezik kötelem (kötelezettség)?<br>a) Jogtalan támadás elhárítása során a támadónak okozott kár esetén.<br>b) A károsult beleegyezésével okozott kár esetén.<br>c) Szükséghelyzetben okozott kár esetén.<br>d) Egyik esetben sem keletkezik.	Szükséghelyzetben okozott kár esetén.
Melyik állítás igaz?<br>a) Kártérítési kötelezettséghez nem szükséges a kár bekövetkezése.<br>b) A kár bekövetkezését a károsultnak kell bizonyítania.<br>c) Akit személyiségi jogában megsértenek, kártérítést követelhet.<br>d) Akit személyiségi jogában megsértenek, kártalanítást követelhet. 	A kár bekövetkezését a károsultnak kell bizonyítania.
Melyik állítás igaz?<br>a) A sérelemdíj megállapításához nem szükséges kár bekövetkezése.<br>b) A becsületsértésért büntetőeljárásban kérhető sérelemdíj.<br>c) A becsületsértésért megítélt pénzbüntetés a sértettet illeti.<br>d) A személyiségi jog megsértése bűncselekmény.	A sérelemdíj megállapításához nem szükséges kár bekövetkezése.
Melyik állítás igaz?<br>a) Az ajándékozás egyoldalú nyilatkozat.<br>b) Ha valaki nyilvánosan díjat ígér egy teljesítményért, nem köteles azt teljesíteni.<br>c) Ha valaki közérdekű célra vállal kötelezettséget, az egy szerződés az állammal.<br>d) A szerződés soha nem lehet egyoldalú nyilatkozat.	A szerződés soha nem lehet egyoldalú nyilatkozat.
Melyik állítás igaz?<br>a) Ha valaki tévedésből többet utal át a vételárnál, nem követelheti azt vissza.<br>b) Ha valaki tévedésből többet utal át a vételárnál, az ajándékozásnak minősül.<br>c) Ha valaki tévedésből többet utal át, a többletet a másik köteles visszatéríteni.<br>d) Ha valaki tévedésből többet utal át, a többlet felét visszakövetelheti.	Ha valaki tévedésből többet utal át, a többletet a másik köteles visszatéríteni.
Melyik állítás igaz?<br>a) Értékpapírt csak írásban, okirati formában lehet kibocsátani.<br>b) Az értékpapír egy szerződés a kibocsátó és a jogosult között.<br>c) Az értékpapírban foglalt követelés nem átruházható.<br>d) A befektetési jegy az értékpapír egyik fajtája.	A befektetési jegy az értékpapír egyik fajtája.
Melyik állítás hamis?<br>a) A váltó hitelviszonyt megtestesítő értékpapír.<br>b) A kötvény tagsági jogokat megtestesítő értékpapír.<br>c) A részvény tagsági jogokat megtestesítő értékpapír.<br>d) A közraktári jegy dologi jogot megtestesítő értékpapír.	A kötvény tagsági jogokat megtestesítő értékpapír.
Az alábbi esetek közül melyikben nem szűnik meg a kötelem (fő szabály szerint)?<br>a) A szolgáltatás teljesítésével.<br>b) A kötelezett halálával.<br>c) Tartozásátvállalás esetén.<br>d) A jogosult jogutód nélküli megszűnése esetén.	Tartozásátvállalás esetén.
Hányféle formában lehet jognyilatkozatot tenni? Sorolja is fel őket.<br>a) 2, amelyek a következők: szóban, írásban<br>b) 3, amelyek a következők: szóban, írásban, ráutaló magatartással<br>c) 4, amelyek a következők: szóban, írásban, tettlegesen, ráutaló magatartással<br>d) 5, amelyek a következők: szóban, írásban, gondolatban, tettlegesen, ráutaló magatartással	3, amelyek a következők: szóban, írásban, ráutaló magatartással
Mikor minősül a jognyilatkozat írásba foglaltnak?<br>a) Ha a nyilatkozó saját kezűleg írta.<br>b) Ha két tanú aláírta.<br>c) Ha a nyilatkozó aláírta.<br>d) Ha ügyvéd aláírta.	Ha a nyilatkozó aláírta.
Az alábbiak közül ki nem készíthet közokiratot?<br>a) Ügyvéd.<br>b) Bíróság.<br>c) Közjegyző.<br>d) Közigazgatási szerv.	Ügyvéd.
Melyik állítás hamis?<br>a) A képviseleti jog alapulhat vállalkozási szerződésen.<br>b) A képviseleti jog alapulhat létesítő okiraton.<br>c) A képviseleti jog alapulhat meghatalmazáson.<br>d) A képviseleti jog alapulhat jogszabályon. 	A képviseleti jog alapulhat vállalkozási szerződésen.
Melyik állítás igaz?<br>a) Jognyilatkozatot csak személyesen lehet tenni.<br>b) A képviselő jognyilatkozata a képviselőt jogosítja és kötelezi.<br>c) A meghatalmazás egyoldalú jognyilatkozat.<br>d) A meghatalmazás szóban nem érvényes.	A meghatalmazás egyoldalú jognyilatkozat.
Hány év alatt évülnek el a követelések (fő szabály szerint)?<br>a) 3 év alatt.<br>b) 5 év alatt. <br>c) 1 év alatt.<br>d) A követelések nem évülnek el.	5 év alatt. 
Melyik állítás igaz?<br>a) Elévült követelés bírósági eljárásban csak jogi képviselettel érvényesíthető.<br>b) Ha valaki elévült követelést teljesít, utóbb visszakövetelheti azt.<br>c) A fogadásból eredő követelés bíróság előtt 1 évig érvényesíthető.<br>d) Mindhárom fenti állítás hamis.	Mindhárom fenti állítás hamis.
Melyik állítás a legpontosabb a szerződésre vonatkozóan?<br>a) A szerződés a felek egyidejű és egybehangzó jognyilatkozata.<br>b) A szerződés a felek kölcsönös és egyidejű jognyilatkozata.<br>c) A szerződés a felek kölcsönös és egybehangzó jognyilatkozata.<br>d) A szerződés a felek kölcsönös, egybehangzó és egyidejű jognyilatkozata.	A szerződés a felek kölcsönös és egybehangzó jognyilatkozata.
Az alábbiak közül melyik nem tartozik a szerződési jog legfontosabb alapelvei közé?<br>a) A szerződési szabadság elve.<br>b) A visszterhesség vélelme.<br>c) Az együttműködési és tájékoztatási kötelezettség.<br>d) A gyengébb fél érdekei védelmének az elve.	A gyengébb fél érdekei védelmének az elve.
Mi történik ha a felek szerződési nyilatkozatai lényeges kérdésben eltérnek?<br>a) A szerződés megtámadható lesz.<br>b) A szerződés érvénytelen lesz.<br>c) A szerződés nem jön létre.<br>d) A bíróság ítéletével kiküszöböli az eltérést.	A szerződés nem jön létre.
Melyik állítás hamis az ajánlatra vonatkozóan?<br>a) Aki ajánlatot tesz, meghatározott ideig kötve van az ajánlathoz.<br>b) Az ajánlati kötöttség idejét a felek közösen határozzák meg.<br>c) Ha a másik fél határidőben elfogadja az ajánlatot, a szerződés létrejön.<br>d) Ha a másik fél eltérő tartalommal fogadja el, az új ajánlatnak minősül.	Az ajánlati kötöttség idejét a felek közösen határozzák meg.
Az alábbiak közül melyikből nem származhat szerződéskötési kötelezettség?<br>a) Jogszabályból.<br>b) Versenyeztetési eljárásból.<br>c) Előszerződésből.<br>d) Mindhárom fentiből származhat.	Mindhárom fentiből származhat.
Melyik állítás igaz?<br>a) Az Általános Szerződési Feltételeket a felek előre, közösen határozzák meg.<br>b) A fogyasztó csak természetes személy lehet.<br>c) Távollévők között kötött szerződés létrejöhet két vállalkozás között is.<br>d) Fogyasztói szerződés esetén a fogyasztót 14 napon belül elállási jog illeti meg.	A fogyasztó csak természetes személy lehet.
Az érvénytelenségnek hányféle formája van a polgári jogban, és melyek ezek?<br>a) 3, éspedig a következők: semmisség, megtámadhatóság, elévülés<br>b) 2, éspedig a következők: semmisség, megtámadhatóság<br>c) 1, éspedig a következő: semmisség<br>d) A polgári jogban nem létezik az érvénytelenség fogalma.	2, éspedig a következők: semmisség, megtámadhatóság
Az alábbiak közül melyik a célzott joghatás hibája?<br>a) A tévedés.<br>b) A megtévesztés.<br>c) A jó erkölcsbe ütközés.<br>d) A jogellenes fenyegetés.	A jó erkölcsbe ütközés.
Az alábbi esetek közül melyikben merül fel a szerződési akarat hibája?<br>a) A megtévesztéssel kötött szerződés.<br>b) Az uzsorás szerződés.<br>c) A jogszabályba ütköző szerződés.<br>d) A nem megfelelő formában megkötött szerződés.	A megtévesztéssel kötött szerződés.
Melyik állítás igaz?<br>a) A jogszabályba ütköző szerződés megtámadható.<br>b) A jogellenes fenyegetéssel kötött szerződés semmis.<br>c) Az uzsorás szerződés semmis.<br>d) Mindhárom fenti állítás hamis.	Az uzsorás szerződés semmis.
Az alábbiak közül melyiknek a jogkövetkezménye a szerződés semmissége?<br>a) A feltűnő értékaránytalansággal kötött szerződés.<br>b) A megtévesztéssel kötött szerződés.<br>c) A jó erkölcsbe ütköző szerződés.<br>d) A jogellenes fenyegetéssel kötött szerződés.	A jó erkölcsbe ütköző szerződés.
Melyik állítás hamis?<br>a) Érvénytelen szerződés alapján a teljesítés nem követelhető.<br>b) Hatálytalan szerződés alapján a teljesítés nem követelhető.<br>c) Érvénytelen szerződés alapján teljesített szolgáltatást nem lehet visszakövetelni.<br>d) Érvénytelen szerződés utóbb érvényessé válhat a felek akaratából.	Érvénytelen szerződés alapján teljesített szolgáltatást nem lehet visszakövetelni.
Szerződésszegés esetén melyiket nem teheti meg a sérelmet szenvedett fél?<br>a) Továbbra is követelheti a teljesítést.<br>b) Fedezeti szerződést köthet és követelheti annak költségeit.<br>c) A nála levő, a másik fél tulajdonát képező dologból kielégítést kereshet.<br>d) A saját szolgáltatását visszatarthatja.	A nála levő, a másik fél tulajdonát képező dologból kielégítést kereshet.
Az alábbiak közül melyik nem tartozik a szerződésszegés nevesített esetei közé?<br>a) A késedelem.<br>b) Az elállás.<br>c) A lehetetlenülés.<br>d) A teljesítés megtagadása.	Az elállás.
Melyik állítás hamis?<br>a) Ha jogosult késedelembe esik a kárveszély átszáll rá.<br>b) Ha a hiba a teljesítés után keletkezett, szavatossági igény nem érvényesíthető.<br>c) Ha a teljesítés lehetetlenné válik, a szerződés megtámadható.<br>d) A kellékszavatossági igények 1 év alatt elévülnek.	Ha a teljesítés lehetetlenné válik, a szerződés megtámadható.
Mennyi a kellékszavatossági igények elévülési ideje fogyasztói szerződés esetén?<br>a) 1 év<br>b) 2 év<br>c) 5 év<br>d) Fogyasztói szerződés esetén ezen igények nem évülnek el.	2 év
Az alábbiak közül melyiket nem választhatja a fogyasztó termékszavatossági igényként?<br>a) A kijavítást.<br>b) A kicserélést.<br>c) Az elállást.<br>d) Mindhármat választhatja.	Az elállást.
Melyik állítás igaz a jótállásra vonatkozóan?<br>a) A jótállás minden szerződés esetén megilleti a szolgáltatás jogosultját.<br>b) A szavatosság és a jótállás ugyanazt jelenti.<br>c) A jótállási idő nem lehet hosszabb 5 évnél.<br>d) A jótállás lehet önkéntes vagy kötelező.	A jótállás lehet önkéntes vagy kötelező.
Az alábbi alanyváltozások közül melyik háromoldalú megállapodás?<br>a) A jogátruházás.<br>b) Az engedményezés.<br>c) A tartozásátvállalás.<br>d) Egyik sem.	A tartozásátvállalás.
Melyik állítás hamis?<br>a) A szerződés felmondása egyoldalú jognyilatkozat.<br>b) Az elállás a jövőre nézve szünteti meg a szerződést.<br>c) A szerződés felbontása a felek közös nyilatkozata.<br>d) A felek a szerződést bármikor megszüntethetik.	Az elállás a jövőre nézve szünteti meg a szerződést.
Az alábbiak közül melyik jog nem alapítható (szerezhető meg) bármikor?<br>a) Az eladási jog.<br>b) A vételi jog.<br>c) A visszavásárlási jog.<br>d) Az elővásárlási jog.	A visszavásárlási jog.
Melyik állítás hamis?<br>a) Az eladási jog jogosultja egyoldalú nyilatkozattal eladhatja a dolgot.<br>b) Az elővásárlási jog jogosultja egyoldalú nyilatkozattal megveheti a dolgot.<br>c) A vételi jog jogosultja egyoldalú nyilatkozattal megveheti a dolgot.<br>d) A visszavásárlási jog jogosultja egyoldalú nyilatkozattal megveheti a dolgot.	Az elővásárlási jog jogosultja egyoldalú nyilatkozattal megveheti a dolgot.
Az alábbiak közül melyiket nem kell az ingatlan-nyilvántartásba bejegyeztetni?<br>a) A tulajdonjog fenntartást.<br>b) A vételi jogot.<br>c) Az eladási jogot.<br>d) Mindhárom fentit be kell jegyeztetni.	Mindhárom fentit be kell jegyeztetni.
Az alábbiak közül melyiket nem kell az ingatlan-nyilvántartásba bejegyeztetni?<br>a) A tulajdonjog fenntartást.<br>b) A vételi jogot.<br>c) Az elbirtoklás megkezdődését.<br>d) Mindhárom fentit be kell jegyeztetni.	Az elbirtoklás megkezdődését.
Melyik állítás igaz?<br>a) Az ajándékozás egyoldalú jognyilatkozat.<br>b) Ajándékozás történhet ellenérték fejében is.<br>c) Az ajándék egyes esetekben visszakövetelhető.<br>d) Az ajándékozásra a jogalap nélküli gazdagodás szabályait kell alkalmazni.	Az ajándék egyes esetekben visszakövetelhető.
Melyik állítás hamis a vállalkozási szerződésre vonatkozóan?<br>a) A vállalkozási szerződés eredménykötelem.<br>b) A megrendelő a teljesítés előtt bármikor elállhat.<br>c) A vállalkozó a teljesítés előtt bármikor elállhat.<br>d) A vállalkozót törvényes zálogjog illeti meg.	A vállalkozó a teljesítés előtt bármikor elállhat.
Az alábbiak közül melyik nem a vállalkozási szerződés altípusa?<br>a) A tervezési szerződés.<br>b) A fuvarozási szerződés.<br>c) A szállítmányozási szerződés.<br>d) A kivitelezési szerződés.	A szállítmányozási szerződés.
Melyik állítás hamis?<br>a) A megbízási szerződés eredménykötelem.<br>b) A megbízó a szerződést felmondhatja.<br>c) A megbízott a szerződést felmondhatja.<br>d) A megbízottat törvényes zálogjog illeti meg.	A megbízási szerződés eredménykötelem.
Az alábbiak közül melyik nem a megbízási szerződés altípusa?<br>a) A bizományi szerződés.<br>b) A szállítmányozási szerződés.<br>c) A közvetítői szerződés.<br>d) A fuvarozási szerződés.	A fuvarozási szerződés.
Az alábbiak közül melyik nem minősül különleges adatnak?<br>a) Az érintett egészségi állapota.<br>b) Az érintett vagyoni helyzete.<br>c) Az érintett vallási meggyőződése.<br>d) Az érintett politikai véleménye.	Az érintett vagyoni helyzete.
Az alábbi műveletek közül melyik nem minősül adatkezelésnek?<br>a) Az adatok gyűjtése.<br>b) Az adatok tárolása.<br>c) Az adatok lekérdezése.<br>d) Mind a három fenti művelet adatkezelésnek minősül.	Mind a három fenti művelet adatkezelésnek minősül.
Az alábbi műveletek közül melyik minősül adatfeldolgozásnak?<br>a) Az adatok gyűjtése.<br>b) Az adatkezelő megbízásából végzett adatkezelési műveletek elvégzése.<br>c) Az adatok lekérdezése.<br>d) Mind a három fenti művelet adatfeldolgozásnak minősül.	Az adatkezelő megbízásából végzett adatkezelési műveletek elvégzése.
Az alábbi 3 állítás közül melyik hamis?<br>a) Személyes adatok kezeléséhez elég ha az érintett szóban hozzájárult.<br>b) Különleges adat csak törvényi előírás alapján kezelhető.<br>c) Bűnügyi személyes adatot csak állami vagy önkormányzati szerv kezelhet.<br>d) Mind a három fenti állítás igaz.	Különleges adat csak törvényi előírás alapján kezelhető.
Az alábbi adatkezelők közül melyiknél nem kötelező adatvédelmi tisztviselő alkalmazása?<br>a) Állami feladatot ellátó adatkezelő szervezetnél.<br>b) Bíróságoknál.<br>c) Közfeladatot ellátó adatkezelő szervezetnél.<br>d) Mindhárom fenti esetben kötelező.	Bíróságoknál.
Az alábbiak jogok közül melyikkel nem rendelkezik a személyes adatok érintettje?<br>a) A törléshez való joggal. <br>b) A helyesbítéshez való joggal.<br>c) Az előzetes tájékozódáshoz való joggal.<br>d) Mindhárom fenti joggal rendelkezik.	Mindhárom fenti joggal rendelkezik.
Az alábbi állítások közül melyik hamis?<br>a) A NAIH elnökét a köztársasági elnök nevezi ki 9 évre.<br>b) Az adatigénylésnek a közfeladatot ellátó szerv 15 napon belül köteles eleget tenni.<br>c) Az adatigénylés költségtérítése a kézbesítés költségét nem tartalmazhatja.<br>d) Adatigénylés benyújtása esetén a jogi képviselet nem kötelező.	Az adatigénylés költségtérítése a kézbesítés költségét nem tartalmazhatja.
Az alábbiak közül melyik esetben nem tiltakozhat az érintett személyes adatának kezelése ellen?<br>a) Közvetlen üzletszerzés céljára történő felhasználás esetén.<br>b) Közvélemény kutatási célú felhasználás esetén.<br>c) Tudományos célú felhasználás esetén.<br>d) Mindhárom fenti esetben tiltakozhat.	Mindhárom fenti esetben tiltakozhat.
Az alábbiak közül melyik esetben nem tiltakozhat az érintett, személyes adatának kezelése ellen?<br>a) Közvetlen üzletszerzés céljára történő felhasználás esetén.<br>b) Közvélemény kutatási célú felhasználás esetén.<br>c) Ha az adatkezelést közérdekű célból törvény rendeli el.<br>d) Mindhárom fenti esetben tiltakozhat.	Ha az adatkezelést közérdekű célból törvény rendeli el.
Az alábbiak közül melyik alkotás nem áll a szerzői jog védelme alatt?<br>a) Ötlet, eljárás.<br>b) Szoftver<br>c) Adatbázis<br>d) Térkép	Ötlet, eljárás.
Mennyi ideig védi a szerzői jog a művet?<br>a) 50 évig.<br>b) A szerző élete végéig.<br>c) A szerző életében és halála után 70 évig.<br>d) 20 évig.	A szerző életében és halála után 70 évig.
Melyik állítás hamis?<br>a) A felhasználási engedély korlátozható valamely területre.<br>b) A felhasználási engedély korlátozható megadott időtartamra.<br>c) A felhasználási engedély korlátozható valamely felhasználási módra.<br>d) A felhasználási engedély szóban is érvényes.	A felhasználási engedély szóban is érvényes.
Mennyi ideig védi a szabadalmi oltalom a találmányt?<br>a) 10 évig.<br>b) 20 évig.<br>c) A szabadalmas élete végéig.<br>d) A szabadalmas életében és halála után 20 évig.	20 évig.