Az alább felsoroltak közül melyik nem jellemző a társadalmi és jogi normákra?<br>a) A hipotetikus szerkezet.<br>b) A szankció.<br>c) A múltra irányultság.<br>d) Mindegyik jellemző.	c) A múltra irányultság.	01_Jogi_alapok
Az alábbiak közül melyik nem tartozik a társadalmi normák lényeges mozzanatai közé?<br>a) A magatartás leírása.<br>b) A magatartás minősítése. (tilos, kötelező stb.)<br>c) A következmények leírása.<br>d) Mindegyik oda tartozik.	d) Mindegyik oda tartozik.	01_Jogi_alapok
Melyik állítás a legjellemzőbb a jogi normákra?<br>a) A társadalom alkotja, érvényesülését az állam biztosítja.<br>b) Az állam alkotja, érvényesülését az állam biztosítja.<br>c) Az állam alkotja, érvényesülését a társadalom biztosítja.<br>d) A társadalom alkotja, érvényesülését a társadalom biztosítja.	b) Az állam alkotja, érvényesülését az állam biztosítja.	01_Jogi_alapok
Az alábbi 3 állítás (a,b,c) közül melyik hamis?<br>a) A jogi normákat gyorsabban meg lehet változtatni, mint az erkölcsi normákat.<br>b) Az erkölcsi normák szankciórendszerét a társadalmi nyomás jellemzi.<br>c) A jogi norma az emberek formális magatartására irányul.<br>d) Mindhárom előző állítás igaz.	d) Mindhárom előző állítás igaz.	01_Jogi_alapok
Az alábbi 3 állítás (a,b,c) közül melyik hamis?<br>a) Az erkölcsi normákat gyorsabban meg lehet változtatni, mint a jogi normákat.<br>b) Az erkölcsi normák szankciórendszerét a társadalmi nyomás jellemzi.<br>c) A jogi norma az emberek formális magatartására irányul.<br>d) Mindhárom előző állítás igaz.	a) Az erkölcsi normákat gyorsabban meg lehet változtatni, mint a jogi normákat.	01_Jogi_alapok
Hányféle módját ismerjük a jogképződésnek, a jogi normák létrejöttének? Sorolja is fel ezeket.<br>a) 2<br>b) 3 szokásjogi, jogalkalmazói (bírói), jogalkotói<br>c) 4<br>d) 5	b) 3 szokásjogi, jogalkalmazói (bírói), jogalkotói	01_Jogi_alapok
Melyik jogképződési mód során jön létre a precedensjog?<br>a) Szokásjogi jogképződés útján.<br>b) Jogalkalmazói jogképződés útján.<br>c) Jogalkotói jogképződés útján.<br>d) Megyegyezés útján.	b) Jogalkalmazói jogképződés útján.	01_Jogi_alapok
A jog melyik funkciójának megvalósítását biztosítja elsősorban a bírósági szervezet?<br>a) Az integráló funkciót.<br>b) A konfliktus-feloldó funkciót.<br>c) A társadalomszervező funkciót.<br>d) Egyik funkció megvalósítását sem biztosítja.	b) A konfliktus-feloldó funkciót.	01_Jogi_alapok
A jog melyik funkciójának megvalósítását biztosítják elsősorban a közigazgatási hatóságok?<br>a) Az integráló funkciót.<br>b) A konfliktus-feloldó funkciót.<br>c) A társadalomszervező funkciót.<br>d) Egyik funkció megvalósítását sem biztosítják.	c) A társadalomszervező funkciót.	01_Jogi_alapok
Az alábbi 3 állítás (a,b,c) közül melyik hamis?<br>a) Az anyagi jogforrás azt a szervet jelenti, amelytől a jogi norma ered.<br>b) Az alaki jogforrás azt a formát jelenti, amelyben a jogi norma megjelenik.<br>c) Elsődleges jogforrás maga a jogalkotó hatalom, az állam. <br>d) Mindhárom előző állítás igaz.	d) Mindhárom előző állítás igaz.	01_Jogi_alapok
Mit mond ki a "Lex superior derogat legi inferiori" alapelv?<br>a) A később megalkotott jogszabály a korábbinak a hatályát lerontja.<br>b) A speciális jogszabályt kell alkalmazni az általánossal szemben.<br>c) Alacsonyabb szintű jogszabály nem ellenkezhet magasabb szintűvel.<br>d) Jogszabállyal ellentétes másik jogszabályt nem lehet alkotni.	c) Alacsonyabb szintű jogszabály nem ellenkezhet magasabb szintűvel.	01_Jogi_alapok
Mit mond ki a "Lex posterior derogat legi priori" alapelv?<br>a) A később megalkotott jogszabály a korábbinak a hatályát lerontja.<br>b) A speciális jogszabályt kell alkalmazni az általánossal szemben.<br>c) Alacsonyabb szintű jogszabály nem ellenkezhet magasabb szintűvel.<br>d) Jogszabállyal ellentétes másik jogszabályt nem lehet alkotni.	a) A később megalkotott jogszabály a korábbinak a hatályát lerontja.	01_Jogi_alapok
Az alábbi jogszabályok közül melyik tartozik az anyagi jog körébe?<br>a) A büntetőeljárásról szóló törvény.<br>b) A polgári eljárásról szóló törvény.<br>c) Az általános közigazgatási rendtartásról szóló törvény.<br>d) Egyik sem.	d) Egyik sem.	01_Jogi_alapok
Az alábbi jogszabályok közül melyik tartozik az anyagi jog körébe?<br>a) A büntetőeljárásról szóló törvény.<br>b) A polgári törvénykönyv.<br>c) Az általános közigazgatási rendtartásról szóló törvény.<br>d) Egyik sem.	b) A polgári törvénykönyv.	01_Jogi_alapok
Az alábbi jogszabályok közül melyik tartozik az alaki jog körébe?<br>a) A büntető törvénykönyv.<br>b) A büntetőeljárásról szóló törvény.<br>c) A polgári törvénykönyv.<br>d) A munka törvénykönyve.	b) A büntetőeljárásról szóló törvény.	01_Jogi_alapok
Melyik állítás igaz?<br>a) A polgári jog a közjog területéhez tartozik.<br>b) A büntetőjog a magánjog területéhez tartozik.<br>c) A kereskedelmi jog a magánjog területéhez tartozik.<br>d) A közigazgatási jog a magánjog területéhez tartozik.	c) A kereskedelmi jog a magánjog területéhez tartozik.	01_Jogi_alapok
Mit nevezünk joghézagnak?<br>a) Amikor a bíróság nem tud választani két alkalmazandó jogszabály közül.<br>b) Amikor két jogszabály egymásnak ellentmondó.<br>c) Amikor a jog nem tartalmaz választ egy adott kérdésre.<br>d) Amikor nincs olyan bíróság, amelyik dönthetne egy adott kérdésben.	c) Amikor a jog nem tartalmaz választ egy adott kérdésre.	01_Jogi_alapok
Melyik jogág szabályozási körébe tartozik a gyülekezési jog?<br>a) Polgári jog.<br>b) Alkotmányjog.<br>c) Munkajog.<br>d) Közigazgatási jog.	b) Alkotmányjog.	01_Jogi_alapok
Melyik állítás igaz az angolszász jogrendszerekre?<br>a) A jogalkotás és jogalkalmazás szférája mereven elválik egymástól.<br>b) A szabályok jelentős része nincs törvénybe foglalva.<br>c) E jogrendszerek pillérei az írott jogforrások.<br>d) A joganyag önálló, zárt rendszert alkot.	b) A szabályok jelentős része nincs törvénybe foglalva.	01_Jogi_alapok
Melyik jogrendszerre a leginkább jellemző, hogy politikailag erősen kötött?<br>a) Az angolszász jogrendszerekre.<br>b) A szocialista jogrendszerekre.<br>c) A kontinentális jogrendszerekre.<br>d) A vallási alapú jogrendszerekre.	b) A szocialista jogrendszerekre.	01_Jogi_alapok
Melyik állítás igaz a kontinentális jogrendszerekre?<br>a) A bírónak jelentős szerepe van a jogalkotásban.<br>b) A jogszabályok kevésbé elvontak és általánosak.<br>c) A joganyag önálló, zárt rendszert alkot.<br>d) A jogszabályok egy-egy vitás ügy eldöntésekor keletkeznek.	c) A joganyag önálló, zárt rendszert alkot.	01_Jogi_alapok
Melyik állítás nem igaz a szocialista jogrendszerekre vonatkozóan?<br>a) A politika közvetlenül befolyásolja a jogot.<br>b) A magánjognak kisebb a jelentősége.<br>c) A jogi túlszabályozás jellemző.<br>d) Mindegyik fenti állítás igaz rá.	d) Mindegyik fenti állítás igaz rá.	01_Jogi_alapok
Melyik állítás nem igaz a szocialista jogrendszerekre vonatkozóan?<br>a) A politika közvetlenül befolyásolja a jogot.<br>b) A magánjognak nagy jelentősége van.<br>c) A jogi túlszabályozás jellemző.<br>d) Mindegyik fenti állítás igaz rá.	b) A magánjognak nagy jelentősége van.	02_Jogszabalytan
A tényeknek olyan összessége, amelyhez valamilyen joghatás fűződik, ...<br>a) a jogi norma diszpozíciója.<br>b) a jogi norma szankciója.<br>c) a jogi norma hipotézise.<br>d) a jogi norma jogkövetkezménye.	c) a jogi norma hipotézise.	02_Jogszabalytan
Az a magatartási szabály, amelyet a jogalkotó a jogalany számára előír, ...<br>a) a jogi norma diszpozíciója.<br>b) a jogi norma szankciója.<br>c) a jogi norma hipotézise.<br>d) a jogi norma jogkövetkezménye.	a) a jogi norma diszpozíciója.	02_Jogszabalytan
Egészítse ki a kipontozott részt.<br>A ... esetén a jogalkotó nem határozza meg, hogy mely tényállás esetén szükséges <br>a normában meghatározott magatartást tanúsítani, csupán példaszerűen felsorolja azokat.<br>a) zárt tényállás<br>b) nyitott tényállás<br>c) parancsoló norma<br>d) diszpozitív norma	b) nyitott tényállás	02_Jogszabalytan
Milyenfajta rendelkezés nem fordulhat elő a jogi norma diszpozíciójában?<br>a) tiltó<br>b) parancsoló<br>c) megengedő<br>d) mindhárom előfordulhat	d) mindhárom előfordulhat	02_Jogszabalytan
Melyik állítás igaz?<br>a) A lopás bűncselekménye mindig vagyoni jellegű szankciót von maga után.<br>b) A jogi norma megsértése nem járhat személyi jellegű szankcióval.<br>c) A szankció egyidejűleg mindig csak egyféle joghátrányt alkalmazhat.<br>d) Az érvénytelenség a szankciók egyik típusa.	d) Az érvénytelenség a szankciók egyik típusa.	02_Jogszabalytan
Melyik állítás igaz?<br>a) Az apaság vélelme nem megdönthető.<br>b) A fikció esetén lehetőség van az ellenkező bizonyítására.<br>c) A 14. életévét be nem töltött személy cselekvőképtelenségének vélelme megdönthető.<br>d) A vélelem legfontosabb jogi következménye a bizonyítási teher megfordítása.	d) A vélelem legfontosabb jogi következménye a bizonyítási teher megfordítása.	02_Jogszabalytan
Melyik állítás igaz?<br>a) Az apaság vélelme megdönthető.<br>b) A fikció esetén lehetőség van az ellenkező bizonyítására.<br>c) A 14. életévét be nem töltött személy cselekvőképtelenségének vélelme megdönthető.<br>d) A fikció legfontosabb jogi következménye a bizonyítási teher megfordítása.	a) Az apaság vélelme megdönthető.	02_Jogszabalytan
Egy jogszabály érvényességének hány feltétele van? Sorolja is fel ezeket.<br>a) 3, a következők:<br>b) 4, a következők: megfelelő szerv; megfelelő eljárás; kihirdetés; hierarchiába illeszkedés<br>c) 2, a következők:<br>d) 5, a következők:	b) 4, a következők: megfelelő szerv; megfelelő eljárás; kihirdetés; hierarchiába illeszkedés	02_Jogszabalytan
Melyik állítás igaz?<br>a) A jogszabály időbeli hatálya nem lehet visszamenőleges.<br>b) A magyar jogszabályok területi hatálya Magyarország teljes területe.<br>c) Egy jogszabály lehet egyidejűleg érvényes, de nem hatályos.<br>d) Egy jogszabály lehet egyidejűleg hatályos és érvénytelen.	c) Egy jogszabály lehet egyidejűleg érvényes, de nem hatályos.	02_Jogszabalytan
Melyik állítás igaz?<br>a) Egy magyar jogszabály minden magyar állampolgárra vonatkozik.<br>b) Egy jogszabály csak a jövőre vonatkozóan állapíthat meg kötelezettséget.<br>c) A személyi hatály azt határozza meg, hogy ki alkotta a jogszabályt.<br>d) Egy magyar jogszabály csak magyar állampolgárokra vonatkozik.	b) Egy jogszabály csak a jövőre vonatkozóan állapíthat meg kötelezettséget.	02_Jogszabalytan
Melyik állítás igaz?<br>a) Egy jogszabály nem érvényes, ha a köztársasági elnök nem írta alá.<br>b) Egy törvény nem érvényes, ha ellenkezik egy rendelettel.<br>c) Egy jogszabály nem érvényes, ha nem hirdették ki.<br>d) Mindhárom fenti állítás hamis.	c) Egy jogszabály nem érvényes, ha nem hirdették ki.	02_Jogszabalytan
Melyik állítás igaz?<br>a) Egy jogszabály nem érvényes, ha a köztársasági elnök nem írta alá.<br>b) Egy rendelet nem érvényes, ha ellenkezik egy törvénnyel.<br>c) Egy jogszabály akkor is érvényes, ha nem hirdették ki.<br>d) Mindhárom fenti állítás hamis.	b) Egy rendelet nem érvényes, ha ellenkezik egy törvénnyel.	02_Jogszabalytan
Melyik állítás igaz?<br>a) A jogszabályok tudományos értelmezésének csak az adott ügyben van kötelező ereje.<br>b) A jogalkotói jogszabály értelmezés minden címzettre nézve kötelező.<br>c) A jogalkalmazói jogszabály értelmezésnek nincs kötelező ereje.<br>d) A jogalkotói jogszabály értelmezés tilos.	b) A jogalkotói jogszabály értelmezés minden címzettre nézve kötelező.	02_Jogszabalytan
Melyik állítás igaz?<br>a) A közigazgatási szervek eljárása mindig kezdeményezésre indul.<br>b) A jogalanyok önkéntes jogkövetését is jogalkalmazásnak tekintjük.<br>c) A jogalkalmazás célja mindig valamilyen jogsérelem orvoslása.<br>d) A jogalkalmazás utolsó lépése a tényállás megállapítása.	b) A jogalanyok önkéntes jogkövetését is jogalkalmazásnak tekintjük.	02_Jogszabalytan
Melyik nem következhet be a jogalkalmazás eredményeképpen?<br>a) Jogviszony keletkezése.<br>b) Jogviszony megszűnése.<br>c) Jogviszony módosulása.<br>d) Mindhárom fenti bekövetkezhet.	d) Mindhárom fenti bekövetkezhet.	02_Jogszabalytan
Mely szerv biztosítja a bíróságok egységes jogalkalmazását?<br>a) Az alkotmánybíróság.<br>b) A törvényszék.<br>c) Az ítélőtábla.<br>d) A Kúria.	d) A Kúria.	02_Jogszabalytan
Mely szerv biztosítja a bíróságok egységes jogalkalmazását?<br>a) Az alkotmánybíróság.<br>b) Az ítélőtábla.<br>c) A Kúria.<br>d) Egyik sem.	c) A Kúria.	02_Jogszabalytan
Melyik nem tartozik a jogszabály értelmezésének módszerei közé?<br>a) A rendszertani értelmezés.<br>b) A történeti értelmezés.<br>c) A módszertani értelmezés.<br>d) A logikai értelmezés.	c) A módszertani értelmezés.	02_Jogszabalytan
A jogviszony szerkezeti elemei közé tartozik<br>a) a jogviszony helye.<br>b) a jogviszony ideje.<br>c) a jogviszony tartalma.<br>d) Egyik sem.	c) a jogviszony tartalma.	02_Jogszabalytan
Ingatlan adásvételi szerződés esetén a jogviszony tárgya<br>a) a vételár kifizetése.<br>b) a tulajdonjog átruházása.<br>c) az ingatlan.<br>d) Egyik sem.	c) az ingatlan.	02_Jogszabalytan
Melyik állítás hamis?<br>a) A kötelmi jogban a relatív szerkezetű jogviszonyok jellemzők.<br>b) A tulajdonjog abszolút szerkezetű jogviszony.<br>c) Ha több, mint 2 fél szerepel a szerződésben, az abszolút szerkezetű jogviszonyt eredményez.<br>d) A károkozás relatív szerkezetű jogviszonyt teremt.	c) Ha több, mint 2 fél szerepel a szerződésben, az abszolút szerkezetű jogviszonyt eredményez.	02_Jogszabalytan
Az alábbiak (a,b,c) közül melyik nem rendelkezik jogi személyiséggel?<br>a) Az Állam.<br>b) Az egyesület.<br>c) A társasház.<br>d) Mindegyik rendelkezik.	c) A társasház.	02_Jogszabalytan
Az alábbiak (a,b,c) közül melyik nem rendelkezik jogi személyiséggel?<br>a) Az Állam.<br>b) Az egyesület.<br>c) Az egyetem.<br>d) Mindegyik rendelkezik.	d) Mindegyik rendelkezik.	03_Szemelyek_joga
Melyik állítás igaz?<br>a) Együttes kötelezettek bármelyikétől az egész tartozás követelhető.<br>b) Egyetemleges kötelezettek egyidejűleg, de arányosan kötelesek teljesíteni.<br>c) A kezes az adóssal fele-fele arányban köteles teljesíteni a tartozást.<br>d) Mindhárom fenti állítás hamis.	d) Mindhárom fenti állítás hamis.	03_Szemelyek_joga
Az alábbi 3 állítás (a,b,c) közül melyik hamis?<br>a) Aki jogképes, az önállóan köthet szerződést.<br>b) Aki jogképes, az jogosultságok alanya lehet.<br>c) Aki betöltötte a 14. életévét az jogképes.<br>d) Mindhárom előző állítás igaz.	a) Aki jogképes, az önállóan köthet szerződést.	03_Szemelyek_joga
Melyik állítás igaz?<br>a) A jogképesség a születéssel kezdődik.<br>b) A jogképesség mindig a születés előtti 300-adik napon kezdődik.<br>c) A jogképesség mindig a fogamzástól kezdődik.<br>d) A magzat jogképessége feltételes.	d) A magzat jogképessége feltételes.	03_Szemelyek_joga
Melyik állítás igaz?<br>a) A bíróság korlátozhatja a természetes személy jogképességét.<br>b) A Ptk. nem korlátozhatja az ember cselekvőképességét.<br>c) Aki cselekvőképes, az önállóan köthet szerződést.<br>d) Mindhárom fenti állítás hamis.	c) Aki cselekvőképes, az önállóan köthet szerződést.	03_Szemelyek_joga
Az alábbi 3 állítás (a,b,c) közül melyik hamis?<br>a) 17 éves személy is lehet nagykorú.<br>b) 17 éves személy is lehet cselekvőképes.<br>c) 13 éves személy is lehet korlátozottan cselekvőképes.<br>d) Mindhárom előző állítás igaz.	c) 13 éves személy is lehet korlátozottan cselekvőképes.	03_Szemelyek_joga
Az alábbi 3 állítás (a,b,c) közül melyik hamis?<br>a) A kiskorú személy a házasságkötéssel nagykorúvá válik.<br>b) 17 éves személy is lehet cselekvőképes.<br>c) A 13 éves személy minden esetben cselekvőképtelennek minősül.<br>d) Mindhárom előző állítás igaz.	d) Mindhárom előző állítás igaz.	03_Szemelyek_joga
Az alábbi 3 állítás (a,b,c) közül melyik hamis?<br>a) Nagykorú személy is lehet cselekvőképtelen.<br>b) Kiskorú személy is lehet korlátozottan cselekvőképes.<br>c) A kiskorú személy házasságkötése minden esetben érvénytelen.<br>d) Mindhárom előző állítás igaz.	c) A kiskorú személy házasságkötése minden esetben érvénytelen.	03_Szemelyek_joga
Mit nem tehet meg önállóan a korlátozottan cselekvőképes kiskorú?<br>a) Tetszőleges értékű ajándékot adhat.<br>b) Tetszőleges értékű ajándékot elfogadhat.<br>c) Rendelkezhet munkával szerzett jövedelmével.<br>d) Mindhárom fenti jognyilatkozatot megteheti önállóan.	a) Tetszőleges értékű ajándékot adhat.	03_Szemelyek_joga
Melyik nem tartozik a gyám feladatai közé?<br>a) A gyermek gondozása, nevelése.<br>b) A gyermek vagyonának kezelése.<br>c) A gyermek törvényes képviselete.<br>d) Mindhárom fenti a gyám feladatai közé tartozik.	d) Mindhárom fenti a gyám feladatai közé tartozik.	03_Szemelyek_joga
Melyikkel nem feltétlenül kell rendelkeznie a jogi személynek?<br>a) Székhellyel.<br>b) Saját vagyonnal.<br>c) Telephellyel.<br>d) Képviselővel.	c) Telephellyel.	03_Szemelyek_joga
Ki felel a jogi személy tartozásaiért?<br>a) A vezető tisztségviselő.<br>b) A döntéshozó szerv.<br>c) A tagok és alapítók.<br>d) Egyik sem.	d) Egyik sem.	03_Szemelyek_joga
Mikor jön létre a jogi személy?<br>a) A létesítő okirat aláírásakor.<br>b) A bejegyzési kérelem bírósághoz történő benyújtásakor.<br>c) A bírósági nyilvántartásba vétel megtörténtekor.<br>d) A bírósági határozat kézbesítésekor.	c) A bírósági nyilvántartásba vétel megtörténtekor.	03_Szemelyek_joga
Ki látja el a jogi személy tulajdonosainak érdekvédelmét?<br>a) A könyvvizsgáló.<br>b) A vezető tisztségviselő.<br>c) A felügyelőbizottság.<br>d) Egyik sem.	c) A felügyelőbizottság.	03_Szemelyek_joga
Ki látja el a jogi személy törvényes működésének felügyeletét?<br>a) Az ügyészség.<br>b) A felügyelőbizottság.<br>c) A nyilvántartó bíróság.<br>d) Egyik sem.	c) A nyilvántartó bíróság.	03_Szemelyek_joga
Melyik állítás hamis?<br>a) Összeolvadásnál a korábbi jogi személyek megszűnnek.<br>b) Kiválásnál a jogi személy megszűnik.<br>c) Különválásnál a jogi személy megszűnik.<br>d) Átalakulásnál a korábbi jogi személy megszűnik.	b) Kiválásnál a jogi személy megszűnik.	03_Szemelyek_joga
Melyik nem tartozik a (jogi személy) jogutód nélküli megszűnés esetei közé?<br>a) A tagok kimondják a megszűnést.<br>b) A létesítő okiratban meghatározott idő eltelik.<br>c) A jogi személy tartozása meghaladja a vagyonát.<br>d) A jogosult szerv megszünteti.	c) A jogi személy tartozása meghaladja a vagyonát.	03_Szemelyek_joga
Melyik állítás igaz?<br>a) Alapítvány létrehozásához legalább 10 alapító szükséges.<br>b) Az egyesület megszűnik, ha tagjainak száma tartósan nem éri el a 12 főt.<br>c) Az egyesület átalakulhat alapítvánnyá.<br>d) Egyik fenti állítás sem igaz.	d) Egyik fenti állítás sem igaz.	03_Szemelyek_joga
Melyik állítás igaz?<br>a) Alapítvány létrehozásához legalább 10 alapító szükséges.<br>b) Az egyesület megszűnik, ha tagjainak száma tartósan nem éri el a 10 főt.<br>c) Az alapítvány átalakulhat egyesületté.<br>d) Egyik fenti állítás sem igaz.	b) Az egyesület megszűnik, ha tagjainak száma tartósan nem éri el a 10 főt.	03_Szemelyek_joga
Egyesületnél mely esetben kötelező a felügyelőbizottság létrehozása?<br>a) Ha a tagok több, mint negyede nem természetes személy.<br>b) Ha a tagok létszáma az 50 főt meghaladja.<br>c) Ha a könyvvizsgáló ezt kéri.<br>d) Egyik fenti esetben sem kötelező.	d) Egyik fenti esetben sem kötelező.	04_Tarsasagi_jog
Egyesületnél mely esetben kötelező a felügyelőbizottság létrehozása?<br>a) Ha a tagok több, mint fele nem természetes személy.<br>b) Ha a tagok létszáma az 50 főt meghaladja.<br>c) Ha a könyvvizsgáló ezt kéri.<br>d) Egyik fenti esetben sem kötelező.	a) Ha a tagok több, mint fele nem természetes személy.	04_Tarsasagi_jog
Melyik állítás igaz?<br>a) Alapítvány nem, de egyesület létrehozható gazdasági tevékenység folytatására.<br>b) Egyesület nem, de alapítvány létrehozható gazdasági tevékenység folytatására.<br>c) Sem egyesület, sem alapítvány nem hozható létre gazdasági tevékenység folytatására.<br>d) Egyesület és alapítvány is létrehozható gazdasági tevékenység folytatására.	c) Sem egyesület, sem alapítvány nem hozható létre gazdasági tevékenység folytatására.	04_Tarsasagi_jog
Melyik jellemző a kontinentális (német) társasági modellre?<br>a) Erősen megosztott a tulajdonosi szerkezet.<br>b) Csekély a társasági formaválaszték.<br>c) A társasági szervek élesen elkülönülnek egymástól.<br>d) Egyik sem jellemző.	c) A társasági szervek élesen elkülönülnek egymástól.	04_Tarsasagi_jog
Melyik nem jellemző az angol-amerikai társasági modellre?<br>a) A társasági jog szorosan összefonódik a tőkepiac intézményeivel.<br>b) A társaságnak egységes vezető szerve van.<br>c) A könyvvizsgáló szerepe és felelőssége csekély.<br>d) Mindegyik fenti állítás jellemző rá.	c) A könyvvizsgáló szerepe és felelőssége csekély.	04_Tarsasagi_jog
Az alábbiak közül melyik szolgálja a közérdeket a társasági jogban?<br>a) A diszpozitív szabályozás.<br>b) A cégnyilvánosság elve.<br>c) A választott bírósági eljárás igénybevételének lehetősége.<br>d) Egyik sem.	b) A cégnyilvánosság elve.	04_Tarsasagi_jog
Melyik társasági forma nem hozható létre egyszemélyes gazdasági társaságként?<br>a) Egyszemélyes korlátolt felelősségű társaság.<br>b) Egyszemélyes betéti társaság.<br>c) Egyszemélyes részvénytársaság.<br>d) Mindhárom forma létrehozható.	b) Egyszemélyes betéti társaság.	04_Tarsasagi_jog
Melyik társasági forma hozható létre egyszemélyes gazdasági társaságként?<br>a) Egyszemélyes betéti társaság.<br>b) Egyszemélyes korlátolt felelősségű társaság.<br>c) Egyszemélyes közkereseti társaság.<br>d) Egyik sem hozható létre.	b) Egyszemélyes korlátolt felelősségű társaság.	04_Tarsasagi_jog
Hány tag alapíthat közkereseti társaságot?<br>a) Legalább egy beltag.<br>b) Legalább egy beltag és egy kültag.<br>c) Legalább két tag.<br>d) Legalább két beltag.	c) Legalább két tag.	04_Tarsasagi_jog
Milyen célt szolgál a társasági formakényszer?<br>a) A hitelezők védelmét.<br>b) A kisebbségi jogok védelmét.<br>c) A társulási szabadság érvényre jutását.<br>d) A közérdeket.	d) A közérdeket.	04_Tarsasagi_jog
Hányféle társasági formában alapítható gazdasági társaság? Sorolja is fel őket.<br>a) 3, a következők:<br>b) 4, a következők: Kkt., Bt., Kft., Zrt.<br>c) 5, a következők:<br>d) Egyik fenti válasz sem megfelelő.	b) 4, a következők: Kkt., Bt., Kft., Zrt.	04_Tarsasagi_jog
Az alábbiak közül melyik szervezet nem rendelkezik jogi személyiséggel?<br>a) A korlátolt felelősségű társaság.<br>b) A betéti társaság.<br>c) A részvénytársaság.<br>d) Mindegyik rendelkezik.	d) Mindegyik rendelkezik.	04_Tarsasagi_jog
Az alábbiak közül melyik szervezet nem rendelkezik jogi személyiséggel?<br>a) A korlátolt felelősségű társaság.<br>b) Az egyéni cég.<br>c) A részvénytársaság.<br>d) Mindegyik rendelkezik.	b) Az egyéni cég.	04_Tarsasagi_jog
Az alábbiak közül melyik nem lehet apport gazdasági társaság alapítása során?<br>a) Egy személyautó.<br>b) Egy találmány.<br>c) Szerződésen alapuló követelés.<br>d) A fentiek mindegyike lehet apport.	c) Szerződésen alapuló követelés.	04_Tarsasagi_jog
Melyik állítás igaz?<br>a) Közkereseti társaság nem lehet egy korlátolt felelősségű társaságnak tagja.<br>b) Betéti társaság nem lehet egy közkereseti társaságnak tagja.<br>c) Korlátolt felelősségű társaság nem lehet egy betéti társaságnak beltagja.<br>d) Részvénytársaságnak csak természetes személyek lehetnek a tagjai.	b) Betéti társaság nem lehet egy közkereseti társaságnak tagja.	04_Tarsasagi_jog
Melyiket nem kezdeményezhetik a G.T. szavazati jogok 5%-ával rendelkező tagjai?<br>a) Egyedi könyvvizsgálatot.<br>b) A legfőbb szerv összehívását.<br>c) Egy tag kizárását.<br>d) A társaság igényének érvényesítését egy taggal szemben.	c) Egy tag kizárását.	04_Tarsasagi_jog
Kik szavazhatnak a gazdasági társaság legfőbb szervének ülésén?<br>a) A társaság tagjai.<br>b) A társaság tagjai és a vezető tisztségviselő.<br>c) A tagok és a felügyelő bizottság tagjai.<br>d) A tagok és a cégvezetők.	a) A társaság tagjai.	04_Tarsasagi_jog
Melyik tartozik a gazdasági társaság felügyelőbizottságának feladatai közé?<br>a) A vezető tisztségviselő megválasztása és visszahívása.<br>b) A könyvvizsgáló ellenőrzése.<br>c) Az ügyvezetés ellenőrzése.<br>d) A beszámoló elkészítése.	c) Az ügyvezetés ellenőrzése.	04_Tarsasagi_jog
A gazdasági társaság melyik szerve kezdeményezheti egy tag kizárását?<br>a) A felügyelő bizottság.<br>b) A legfőbb szerv.<br>c) A vezető tisztségviselő.<br>d) Egyik sem, mert tagot nem lehet kizárni.	b) A legfőbb szerv.	05_Egyeb_jogalanyok
Melyik szerv dönt a társaság jogutód nélküli megszűnéséről?<br>a) A legfőbb szerv.<br>b) A felügyelő bizottság.<br>c) A vezető tisztségviselő.<br>d) A könyvvizsgáló.	a) A legfőbb szerv.	05_Egyeb_jogalanyok
Melyik állítás hamis a Kft-re vonatkozóan?<br>a) Kft. esetén a tagok törzsbetétei különböző mértékűek lehetnek.<br>b) Az egyes törzsbetétek mértéke legalább 100.000 Ft.<br>c) A törzstbetétek összege a törzstőke, melynek minimális mértéke 1 millió Ft.<br>d) Egy tagnak több üzletrésze is lehet.	c) A törzstbetétek összege a törzstőke, melynek minimális mértéke 1 millió Ft.	05_Egyeb_jogalanyok
Melyik állítás hamis?<br>a) A Bt. alaptőkéje nem lehet kevesebb, mint 100.000 Ft.<br>b) A Zrt. alaptőkéje nem lehet kevesebb, mint 5 millió Ft.<br>c) Az Nyrt. alaptőkéje nem lehet kevesebb, mint 20 millió Ft.<br>d) A közkereseti társaság alaptőkéjére nincs minimális előírás.	a) A Bt. alaptőkéje nem lehet kevesebb, mint 100.000 Ft.	05_Egyeb_jogalanyok
Kinek a tulajdona a betéti társaság vagyona?<br>a) A beltagok közös tulajdona.<br>b) Valamennyi tag közös tulajdona.<br>c) A társaság tulajdona.<br>d) Az alapító tagok közös tulajdona.	c) A társaság tulajdona.	05_Egyeb_jogalanyok
Melyik állítás hamis?<br>a) Az egyesülés jogi személyiséggel rendelkezik.<br>b) Az egyesülés vagyonát meghaladó tartozásaiért a tagok nem felelnek.<br>c) Az egyesülés saját nyereségre nem törekszik.<br>d) Az egyesülés célja a tagok tevékenységének összehangolása.	b) Az egyesülés vagyonát meghaladó tartozásaiért a tagok nem felelnek.	05_Egyeb_jogalanyok
Melyik állítás igaz?<br>a) A szövetkezet tagjainak többsége természetes személy.<br>b) A szövetkezet valamennyi tagjának személyes közreműködést kell vállalnia.<br>c) Szövetkezeti jogvitára választott-bírósági eljárás nem köthető ki.<br>d) A szövetkezet nem rendelkezik jogi személyiséggel.	a) A szövetkezet tagjainak többsége természetes személy.	05_Egyeb_jogalanyok
Hány személy alapíthat szövetkezetet?<br>a) Legalább 2 személy.<br>b) Legalább 3 személy.<br>c) Legalább 10 személy.<br>d) Egy személy is alapíthat.	b) Legalább 3 személy.	05_Egyeb_jogalanyok
Melyik állítás hamis?<br>a) A szövetkezet közgyűlésén minden tagnak egy szavazata van.<br>b) Szövetkezetnél kötelező a könyvvizsgáló kinevezése.<br>c) Szövetkezetnél kötelező a felügyelőbizottság működése. <br>d) A szövetkezet ügyvezetését az igazgatóság látja el.	b) Szövetkezetnél kötelező a könyvvizsgáló kinevezése.	05_Egyeb_jogalanyok
Melyik szervezet nem vehet részt tagként vállalatcsoportban?<br>a) Korlátolt felelősségű társaság.<br>b) Szövetkezet.<br>c) Egyesülés.<br>d) Betéti társaság.	d) Betéti társaság.	05_Egyeb_jogalanyok
Melyik állítás hamis a vállalatcsoportra vonatkozóan?<br>a) Legalább egy uralkodó tag és 3 ellenőrzött tag szükséges hozzá.<br>b) A cégbíróság a cégnyilvántartásba bejegyzi.<br>c) Az uralkodó tag nem utasíthatja az ellenőrzött tagokat.<br>d) Önálló jogi személyiséggel nem rendelkezik.	c) Az uralkodó tag nem utasíthatja az ellenőrzött tagokat.	05_Egyeb_jogalanyok
Az alábbiak közül ki nem lehet egyéni vállalkozó?<br>a) 17 éves, házasságot kötött személy.<br>b) Közkereseti társaság tagja.<br>c) Korlátolt felelősségű társaság tagja.<br>d) Betéti társaság kültagja.	b) Közkereseti társaság tagja.	05_Egyeb_jogalanyok
Melyik szervezet vezeti az egyéni vállalkozók nyilvántartását?<br>a) A Nemzeti Adó és Vámhivatal (NAV).<br>b) A cégbíróság.<br>c) A törvényszék.<br>d) A céginformációs szolgálat.	a) A Nemzeti Adó és Vámhivatal (NAV).	05_Egyeb_jogalanyok
Melyik állítás igaz?<br>a) Az egyéni vállalkozónak nem lehet alkalmazottja.<br>b) A tevékenység csak egyéni vállalkozói igazolvány kiállítása után végezhető.<br>c) Az egyéni vállalkozó a kötelezettségeiért csak vállalkozói vagyonával felel. <br>d) Az egyéni vállalkozó köteles személyesen közreműködni a tevékenység folytatásában.	d) Az egyéni vállalkozó köteles személyesen közreműködni a tevékenység folytatásában.	05_Egyeb_jogalanyok
Melyik állítás hamis az egyéni cégre vonatkozóan?<br>a) Az egyéni cég jogképes.<br>b) Az egyéni cég jogi személyiséggel rendelkezik.<br>c) Az egyéni céget a cégbíróság tartja nyilván.<br>d) Az egyéni cégnek cégjegyzékszáma van.	b) Az egyéni cég jogi személyiséggel rendelkezik.	05_Egyeb_jogalanyok
Ki alapíthat egyéni céget?<br>a) Minden nagykorú, cselekvőképes személy.<br>b) Minden nagykorú, cselekvőképes magyar állampolgár.<br>c) Aki az egyéni vállalkozói nyilvántartásban szerepel.<br>d) Minden nagykorú, cselekvőképes személy, aki nem korlátlanul felelős tagja G.T.-nak.	c) Aki az egyéni vállalkozói nyilvántartásban szerepel.	06_Cegeljaras
Az alábbiak közül melyik nem lehet egy egyéni cég alapításkori jegyzett tőkéje?<br>a) 100.000 Ft plusz egy 200.000 Ft értékű autó.<br>b) 100.000 Ft plusz egy 100.000 Ft értékű autó.<br>c) Egy 300.000 Ft értékű autó. <br>d) 100.000 Ft.	b) 100.000 Ft plusz egy 100.000 Ft értékű autó.	06_Cegeljaras
Melyik állítás hamis?<br>a) A köztestület közfeladatot lát el.<br>b) A köztestületet a tagjai szabad elhatározásukkal hozzák létre.<br>c) A köztestület jogi személy.<br>d) A Magyar Orvosi Kamara is egy köztestület.	b) A köztestületet a tagjai szabad elhatározásukkal hozzák létre.	06_Cegeljaras
Az alábbiak közül (a,b,c) melyik nem köztestület?<br>a) Magyar Tudományos Akadémia<br>b) Magyar Ügyvédi Kamara<br>c) Magyar Labdarúgó Szövetség<br>d) Mindhárom köztestület	c) Magyar Labdarúgó Szövetség	06_Cegeljaras
Az alábbiak közül (a,b,c) melyik nem köztestület?<br>a) Magyar Tudományos Akadémia<br>b) Magyar Ügyvédi Kamara<br>c) Magyar Kereskedelmi és Iparkamara<br>d) Mindhárom köztestület	d) Mindhárom köztestület	06_Cegeljaras
Az alábbiak közül melyik nem lehet közhasznú státuszú?<br>a) A köztestület.<br>b) Az egyesület.<br>c) Az alapítvány.<br>d) A nonprofit Kft.	a) A köztestület.	06_Cegeljaras
Az alábbi jogalanyok közül melyiknek nincs cégjegyzékszáma?<br>a) Az egyesülésnek.<br>b) A szövetkezetnek.<br>c) Az egyesületnek.<br>d) Az egyéni cégnek.	c) Az egyesületnek.	06_Cegeljaras
Az alábbiak közül melyik nem a cégbíróság feladata?<br>a) Cégbejegyzési eljárás lefolytatása.<br>b) Felszámolási eljárás lefolytatása.<br>c) Döntés a közhasznúvá minősítésről.<br>d) Törvényességi felügyeleti eljárás lefolytatása cégekkel kapcsolatban.	b) Felszámolási eljárás lefolytatása.	06_Cegeljaras
Az alábbi esetek közül melyik fordulhat elő egy céggel kapcsolatban?<br>a) Székhelye Vácon van, telephelye nincs, fióktelepe Vácon van.<br>b) Székhelye nincs, telephelye Vácon van, fióktelepe Vácon van.<br>c) Székhelye Vácon van, telephelye Vácon van, fióktelepe nincs.<br>d) Székhelye Vácon van, telephelye Vácon van, fióktelepe Vácon van.	c) Székhelye Vácon van, telephelye Vácon van, fióktelepe nincs.	06_Cegeljaras
Melyik állítás hamis?<br>a) A cégbejegyzési kérelmet csak elektronikus úton lehet benyújtani.<br>b) A cégbejegyzési eljárás nem-peres eljárás. <br>c) A kérelmet a létesítő okirat aláírásától számított 30 napon belül kell benyújtani.<br>d) A cégbejegyzési eljárás során a jogi képviselet nem kötelező.	d) A cégbejegyzési eljárás során a jogi képviselet nem kötelező.	06_Cegeljaras
Ki dönt egy cég esetén a végelszámolásról?<br>a) A cégbíróság.<br>b) A cég legfőbb szerve.<br>c) A vezető tisztségviselő.<br>d) A hitelező(k).	b) A cég legfőbb szerve.	06_Cegeljaras
Mikor van helye egyszerűsített cégbejegyzési eljárásnak?<br>a) Egyéni cég és Bt. alapításakor.<br>b) Ha a cég alaptőkéje nem haladja meg a 100.000 Ft-ot.<br>c) Ha a létesítő okirat szerződésminta alapján készült.<br>d) Ha a tagok száma egy fő.	c) Ha a létesítő okirat szerződésminta alapján készült.	06_Cegeljaras
Mely cégeknek kell bankszámlával rendelkeznie?<br>a) Csak a Zrt.-nek és az Nyrt.-nek.<br>b) A gazdasági társaságoknak.<br>c) A Zrt.-nek, Nyrt.-nek és a Kft.-nek.<br>d) Minden cégnek bankszámlával kell rendelkeznie.	d) Minden cégnek bankszámlával kell rendelkeznie.	06_Cegeljaras
Mennyi egy Zrt. egyszerűsített cégbejegyzési eljárásának illetéke?<br>a) 10.000 Ft<br>b) 50.000 Ft<br>c) 100.000 Ft<br>d) Az eljárás illetékmentes.	b) 50.000 Ft	06_Cegeljaras
Mennyi egy Kft. rendes (nem egyszerűsített) cégbejegyzési eljárásának illetéke?<br>a) 10.000 Ft<br>b) 50.000 Ft<br>c) 100.000 Ft<br>d) Az eljárás illetékmentes.	d) Az eljárás illetékmentes.	06_Cegeljaras
Ki képviseli a céget a végelszámolás kezdő időpontja után?<br>a) A vezető tisztségviselő.<br>b) A vagyonfelügyelő.<br>c) A felügyelőbizottság elnöke.<br>d) A végelszámoló.	d) A végelszámoló.	06_Cegeljaras
Melyik eljárásnak nem célja a cég jogutód nélküli megszüntetése?<br>a) A felszámolási eljárásnak.<br>b) A csődeljárásnak.<br>c) A végelszámolásnak.<br>d) Mindegyiknek az a célja.	b) A csődeljárásnak.	07_Dologi_jog
Mi a csődeljárás célja?<br>a) A fizetésképtelen adós cég jogutód nélküli megszüntetése.<br>b) A nem fizetésképtelen cég jogutód nélküli megszüntetése.<br>c) Az adós cég fizetési haladékot kap a hitelezőkkel való megegyezés céljából.<br>d) Az adós cég vagyonának hatósági árverésen való értékesítése.	c) Az adós cég fizetési haladékot kap a hitelezőkkel való megegyezés céljából.	07_Dologi_jog
Mi a végelszámolás célja?<br>a) A fizetésképtelen adós cég jogutód nélküli megszüntetése.<br>b) A nem fizetésképtelen cég jogutód nélküli megszüntetése.<br>c) Az adós cég fizetési haladékot kap a hitelezőkkel való megegyezés céljából.<br>d) Az adós cég vagyonának hatósági árverésen való értékesítése.	b) A nem fizetésképtelen cég jogutód nélküli megszüntetése.	07_Dologi_jog
Mi a felszámolási eljárás célja?<br>a) A fizetésképtelen adós cég jogutód nélküli megszüntetése.<br>b) A nem fizetésképtelen cég jogutód nélküli megszüntetése.<br>c) Az adós cég fizetési haladékot kap a hitelezőkkel való megegyezés céljából.<br>d) Az adós cég vagyonának hatósági árverésen való értékesítése.	a) A fizetésképtelen adós cég jogutód nélküli megszüntetése.	07_Dologi_jog
Melyik eljárás indul meg a cégbírósághoz benyújtott változásbejegyzési kérelemmel?<br>a) Csődeljárás.<br>b) Végelszámolás.<br>c) Felszámolási eljárás.<br>d) A fentiek közül egyik sem.	b) Végelszámolás.	07_Dologi_jog
Melyik eljárást indíthatja meg a hitelező az adós cég ellen?<br>a) A végelszámolást.<br>b) A csődeljárást.<br>c) A felszámolási eljárást.<br>d) Kényszer-törlési eljárást.	c) A felszámolási eljárást.	07_Dologi_jog
Melyik eljárást milyen fórumon kell megindítani? Válassza ki a helyeset.<br>a) Csődeljárást a cégbíróságon.<br>b) Felszámolási eljárást a rendes bíróságon (törvényszéken).<br>c) Végelszámolást a rendes bíróságon (törvényszéken).<br>d) Cégbejegyzési eljárást a rendes bíróságon (törvényszéken).	b) Felszámolási eljárást a rendes bíróságon (törvényszéken).	07_Dologi_jog
Kivel szemben nem illeti meg a birtokvédelem joga a birtokost?<br>a) A tulajdonossal szemben.<br>b) A hitelezővel szemben.<br>c) Azzal szemben, akitől a dolgot tilos önhatalommal szerezte meg.<br>d) Kivétel nélkül mindenkivel szemben megilleti.	c) Azzal szemben, akitől a dolgot tilos önhatalommal szerezte meg.	07_Dologi_jog
Melyek a birtokvédelem megengedett eszközei?<br>a) Minden esetben a bírósághoz kell fordulni.<br>b) Minden esetben a jegyzőhöz kell fordulni.<br>c) Minden esetben a rendőrséghez kell fordulni.<br>d) Bírósághoz vagy jegyzőhöz fordulás, speciális esetben önhatalommal való fellépés.	d) Bírósághoz vagy jegyzőhöz fordulás, speciális esetben önhatalommal való fellépés.	07_Dologi_jog
Az alábbiak közül melyik nem tartozik a "szükséges költségek" körébe?<br>a) Az állagmegóvásra fordított költségek.<br>b) A kártól való megóvásra fordított költségek.<br>c) A dolog értékét növelő költségek.<br>d) Mindhárom fenti a "szükséges" költségek körébe tartozik.	c) A dolog értékét növelő költségek.	07_Dologi_jog
Milyen költségei megtérítését követelheti a rosszhiszemű jogalap nélküli birtokos?<br>a) A dologra fordított szükséges költségei megtérítését.<br>b) A dologra fordított hasznos költségei megtérítését.<br>c) A szükséges és hasznos költségei megtérítését is követelheti.<br>d) Semmilyen költségei megtérítését nem követelheti.	a) A dologra fordított szükséges költségei megtérítését.	07_Dologi_jog
Az alábbiak közül melyik nem lehet tulajdonjog tárgya?<br>a) Az elektromos energia (villamos áram).<br>b) A szellemi alkotás.<br>c) Az állatok.<br>d) Az értékpapír.	b) A szellemi alkotás.	07_Dologi_jog
Az alábbi 3 állítás (a,b,c) közül melyik hamis?<br>a) Az ingatlan tulajdonosa a használat jogát másnak átengedheti.<br>b) Az ingatlan tulajdonosa a tulajdonjogát másra átruházhatja.<br>c) Az ingatlan tulajdonosa a tulajdonjogával felhagyhat.<br>d) Mindhárom előző állítás igaz.	c) Az ingatlan tulajdonosa a tulajdonjogával felhagyhat.	07_Dologi_jog
Melyik állítás igaz?<br>a) Szükséghelyzetben okozott kár esetén a (károsult) tulajdonos kártérítést követelhet.<br>b) Közérdekű használat esetén a tulajdonost kártérítés illeti meg.<br>c) Kisajátítás esetén a tulajdonost kártérítés illeti meg.<br>d) Mindhárom fenti esetben kártalanítás és nem kártérítés illeti meg a tulajdonost.	d) Mindhárom fenti esetben kártalanítás és nem kártérítés illeti meg a tulajdonost.	07_Dologi_jog
Melyik állítás igaz?<br>a) Jogellenes károkozás esetén a (károsult) tulajdonos kártérítést követelhet.<br>b) Közérdekű használat esetén a tulajdonost kártérítés illeti meg.<br>c) Kisajátítás esetén a tulajdonost kártérítés illeti meg.<br>d) Mindhárom fenti esetben kártalanítás és nem kártérítés illeti meg a tulajdonost.	a) Jogellenes károkozás esetén a (károsult) tulajdonos kártérítést követelhet.	07_Dologi_jog
Az alábbiak közül melyik tulajdonszerzési mód származékos?<br>a) Tulajdon átruházás.<br>b) Hatósági árverés útján való tulajdonszerzés.<br>c) Elbirtoklás.<br>d) Kisajátítás.	a) Tulajdon átruházás.	07_Dologi_jog
Mikor száll át az ingatlan tulajdonjoga átruházás esetén?<br>a) A szerződés megkötésekor.<br>b) A felek által a szerződésben meghatározott időpontban.<br>c) A birtokbaadáskor.<br>d) Az új tulajdonosnak az ingatlan-nyilvántartásba való bejegyzésével.	d) Az új tulajdonosnak az ingatlan-nyilvántartásba való bejegyzésével.	07_Dologi_jog
Melyik állítás hamis?<br>a) Kisajátítás csak közérdekű célra lehetséges.<br>b) Kisajátítani csak ingatlant lehet.<br>c) A kisajátítást csak az állam kérheti.<br>d) A kisajátítási eljárás során a kisajátítási hatóság tárgyalást tart.	c) A kisajátítást csak az állam kérheti.	08_Kotelmi_jog
Melyik állítás igaz?<br>a) Az ingatlan elbirtoklási ideje 10 év.<br>b) Bűncselekménnyel megszerzett dolgon nem következik be az elbirtoklás.<br>c) Ingatlan elbirtoklásához a tulajdonjogot az ingatlan-nyilvántartásba be kell jegyezni.<br>d) Elbirtoklással csak ingó dolog tulajdonjogát lehet megszerezni.	b) Bűncselekménnyel megszerzett dolgon nem következik be az elbirtoklás.	08_Kotelmi_jog
Melyik állítás hamis?<br>a) Villamoson felejtett dolgon nem lehet találással tulajdont szerezni.<br>b) Gazdátlan dolgon nem lehet találással tulajdont szerezni.<br>c) A találó csak akkor válik tulajdonossá, ha a korábbi tulajdonos 1 éven belül nem jelentkezik.<br>d) A találás származékos tulajdonszerzési mód.	d) A találás származékos tulajdonszerzési mód.	08_Kotelmi_jog
Melyik állítás hamis a zálogjogviszony esetén?<br>a) A jogviszony alanya a személyes kötelezett és a zálogjogosult.<br>b) A zálogtárgy tulajdonosa a zálogkötelezett.<br>c) A zálogjogosult kielégítési joga akkor nyílik meg, ha a személyes kötelezett nem teljesít. <br>d) A zálogkötelezett csak a zálogtárggyal felel a zálogjogosultnak.	a) A jogviszony alanya a személyes kötelezett és a zálogjogosult.	08_Kotelmi_jog
Melyik állítás hamis a zálogjogviszony esetén?<br>a) A jogviszony alanya a zálogkötelezett és a zálogjogosult.<br>b) A zálogtárgy tulajdonosa a zálogjogosult.<br>c) A zálogjogosult kielégítési joga akkor nyílik meg, ha a személyes kötelezett nem teljesít. <br>d) A zálogkötelezett csak a zálogtárggyal felel a zálogjogosultnak.	b) A zálogtárgy tulajdonosa a zálogjogosult.	08_Kotelmi_jog
Melyik állítás hamis a zálogjogviszony esetén?<br>a) A jogviszony alanya a zálogkötelezett és a zálogjogosult.<br>b) A zálogtárgy tulajdonosa a zálogkötelezett.<br>c) A zálogjogosult kielégítési joga akkor nyílik meg, ha a személyes kötelezett nem teljesít. <br>d) A zálogkötelezett teljes vagyonával felel a zálogjogosultnak.	d) A zálogkötelezett teljes vagyonával felel a zálogjogosultnak.	08_Kotelmi_jog
Melyik állítás hamis a zálogjogviszony esetén?<br>a) Az óvadék is a zálog egy fajtája.<br>b) Jelzálogjog csak ingatlanon alapítható.<br>c) Kézizálogjog tárgya csak ingó dolog lehet.<br>d) A személyes kötelezett és a zálogkötelezett lehet ugyanaz a személy.	b) Jelzálogjog csak ingatlanon alapítható.	08_Kotelmi_jog
Melyiket nem teheti meg a haszonélvezeti jog jogosultja?<br>a) A dolgot nem hasznosíthatja.<br>b) A haszonélvezeti jogot nem ruházhatja át.<br>c) A dolgot nem tarthatja a birtokában.<br>d) A fenti 3 mindegyikét megteheti.	b) A haszonélvezeti jogot nem ruházhatja át.	08_Kotelmi_jog
Az alábbi esetek közül melyikben nem használhatja a birtokos a dolgot?<br>a) Haszonkölcsön esetén.<br>b) Kézizálog esetén.<br>c) Haszonélvezeti jog esetén.<br>d) A fenti esetek mindegyikében használhatja.	b) Kézizálog esetén.	08_Kotelmi_jog
Az alábbiak közül melyik magatartásra nem irányulhat a kötelem?<br>a) Valaminek az adására.<br>b) Valamilyen tevékenység elvégzésére.<br>c) Valamitől való tartózkodásra.<br>d) Mindegyik fenti magatartásra irányulhat.	d) Mindegyik fenti magatartásra irányulhat.	08_Kotelmi_jog
Az alábbiak közül melyikből nem keletkezhet kötelem?<br>a) Jogalap nélküli gazdagodásból.<br>b) Személyiségi jog megsértéséből.<br>c) Utaló magatartásból.<br>d) A fentiek mindegyikéből keletkezhet.	d) A fentiek mindegyikéből keletkezhet.	08_Kotelmi_jog
Az alábbiak közül melyik károkozás jogellenes?<br>a) A károsult beleegyezésével okozott kár.<br>b) Jogtalan támadás elhárítása során a támadónak okozott kár.<br>c) Szükséghelyzetben okozott kár.<br>d) A fentiek egyike sem jogellenes.	d) A fentiek egyike sem jogellenes.	08_Kotelmi_jog
Az alábbiak közül melyik esetben keletkezik kötelem (kötelezettség)?<br>a) Jogtalan támadás elhárítása során a támadónak okozott kár esetén.<br>b) A károsult beleegyezésével okozott kár esetén.<br>c) Szükséghelyzetben okozott kár esetén.<br>d) Egyik esetben sem keletkezik.	c) Szükséghelyzetben okozott kár esetén.	08_Kotelmi_jog
Melyik állítás igaz?<br>a) Kártérítési kötelezettséghez nem szükséges a kár bekövetkezése.<br>b) A kár bekövetkezését a károsultnak kell bizonyítania.<br>c) Akit személyiségi jogában megsértenek, kártérítést követelhet.<br>d) Akit személyiségi jogában megsértenek, kártalanítást követelhet.	b) A kár bekövetkezését a károsultnak kell bizonyítania.	08_Kotelmi_jog
Melyik állítás igaz?<br>a) A sérelemdíj megállapításához nem szükséges kár bekövetkezése.<br>b) A becsületsértésért büntetőeljárásban kérhető sérelemdíj.<br>c) A becsületsértésért megítélt pénzbüntetés a sértettet illeti.<br>d) A személyiségi jog megsértése bűncselekmény.	a) A sérelemdíj megállapításához nem szükséges kár bekövetkezése.	08_Kotelmi_jog
Melyik állítás igaz?<br>a) Az ajándékozás egyoldalú nyilatkozat.<br>b) Ha valaki nyilvánosan díjat ígér egy teljesítményért, nem köteles azt teljesíteni.<br>c) Ha valaki közérdekű célra vállal kötelezettséget, az egy szerződés az állammal.<br>d) A szerződés soha nem lehet egyoldalú nyilatkozat.	d) A szerződés soha nem lehet egyoldalú nyilatkozat.	08_Kotelmi_jog
Melyik állítás igaz?<br>a) Ha valaki tévedésből többet utal át a vételárnál, nem követelheti azt vissza.<br>b) Ha valaki tévedésből többet utal át a vételárnál, az ajándékozásnak minősül.<br>c) Ha valaki tévedésből többet utal át, a többletet a másik köteles visszatéríteni.<br>d) Ha valaki tévedésből többet utal át, a többlet felét visszakövetelheti.	c) Ha valaki tévedésből többet utal át, a többletet a másik köteles visszatéríteni.	08_Kotelmi_jog
Melyik állítás igaz?<br>a) Értékpapírt csak írásban, okirati formában lehet kibocsátani.<br>b) Az értékpapír egy szerződés a kibocsátó és a jogosult között.<br>c) Az értékpapírban foglalt követelés nem átruházható.<br>d) A befektetési jegy az értékpapír egyik fajtája.	d) A befektetési jegy az értékpapír egyik fajtája.	09_Szerzodesek
Melyik állítás hamis?<br>a) A váltó hitelviszonyt megtestesítő értékpapír.<br>b) A kötvény tagsági jogokat megtestesítő értékpapír.<br>c) A részvény tagsági jogokat megtestesítő értékpapír.<br>d) A közraktári jegy dologi jogot megtestesítő értékpapír.	b) A kötvény tagsági jogokat megtestesítő értékpapír.	09_Szerzodesek
Az alábbi esetek közül melyikben nem szűnik meg a kötelem (fő szabály szerint)?<br>a) A szolgáltatás teljesítésével.<br>b) A kötelezett halálával.<br>c) Tartozásátvállalás esetén.<br>d) A jogosult jogutód nélküli megszűnése esetén.	c) Tartozásátvállalás esetén.	09_Szerzodesek
Hányféle formában lehet jognyilatkozatot tenni? Sorolja is fel őket.<br>a) 2, amelyek a következők:<br>b) 3, amelyek a következők: szóban, írásban, ráutaló magatartással<br>c) 4, amelyek a következők:<br>d) 5, amelyek a következők:	b) 3, amelyek a következők: szóban, írásban, ráutaló magatartással	09_Szerzodesek
Mikor minősül a jognyilatkozat írásba foglaltnak?<br>a) Ha a nyilatkozó saját kezűleg írta.<br>b) Ha két tanú aláírta.<br>c) Ha a nyilatkozó aláírta.<br>d) Ha ügyvéd aláírta.	c) Ha a nyilatkozó aláírta.	09_Szerzodesek
Az alábbiak közül ki nem készíthet közokiratot?<br>a) Ügyvéd.<br>b) Bíróság.<br>c) Közjegyző.<br>d) Közigazgatási szerv.	a) Ügyvéd.	09_Szerzodesek
Melyik állítás hamis?<br>a) A képviseleti jog alapulhat vállalkozási szerződésen.<br>b) A képviseleti jog alapulhat létesítő okiraton.<br>c) A képviseleti jog alapulhat meghatalmazáson.<br>d) A képviseleti jog alapulhat jogszabályon.	a) A képviseleti jog alapulhat vállalkozási szerződésen.	09_Szerzodesek
Melyik állítás igaz?<br>a) Jognyilatkozatot csak személyesen lehet tenni.<br>b) A képviselő jognyilatkozata a képviselőt jogosítja és kötelezi.<br>c) A meghatalmazás egyoldalú jognyilatkozat.<br>d) A meghatalmazás szóban nem érvényes.	c) A meghatalmazás egyoldalú jognyilatkozat.	09_Szerzodesek
Hány év alatt évülnek el a követelések (fő szabály szerint)?<br>a) 3 év alatt.<br>b) 5 év alatt. <br>c) 1 év alatt.<br>d) A követelések nem évülnek el.	b) 5 év alatt. 	09_Szerzodesek
Melyik állítás igaz?<br>a) Elévült követelés bírósági eljárásban csak jogi képviselettel érvényesíthető.<br>b) Ha valaki elévült követelést teljesít, utóbb visszakövetelheti azt.<br>c) A fogadásból eredő követelés bíróság előtt 1 évig érvényesíthető.<br>d) Mindhárom fenti állítás hamis.	d) Mindhárom fenti állítás hamis.	09_Szerzodesek
Melyik állítás a legpontosabb a szerződésre vonatkozóan?<br>a) A szerződés a felek egyidejű és egybehangzó jognyilatkozata.<br>b) A szerződés a felek kölcsönös és egyidejű jognyilatkozata.<br>c) A szerződés a felek kölcsönös és egybehangzó jognyilatkozata.<br>d) A szerződés a felek kölcsönös, egybehangzó és egyidejű jognyilatkozata.	c) A szerződés a felek kölcsönös és egybehangzó jognyilatkozata.	09_Szerzodesek
Az alábbiak közül melyik nem tartozik a szerződési jog legfontosabb alapelvei közé?<br>a) A szerződési szabadság elve.<br>b) A visszterhesség vélelme.<br>c) Az együttműködési és tájékoztatási kötelezettség.<br>d) A gyengébb fél érdekei védelmének az elve.	d) A gyengébb fél érdekei védelmének az elve.	09_Szerzodesek
Mi történik ha a felek szerződési nyilatkozatai lényeges kérdésben eltérnek?<br>a) A szerződés megtámadható lesz.<br>b) A szerződés érvénytelen lesz.<br>c) A szerződés nem jön létre.<br>d) A bíróság ítéletével kiküszöböli az eltérést.	c) A szerződés nem jön létre.	09_Szerzodesek
Melyik állítás hamis az ajánlatra vonatkozóan?<br>a) Aki ajánlatot tesz, meghatározott ideig kötve van az ajánlathoz.<br>b) Az ajánlati kötöttség idejét a felek közösen határozzák meg.<br>c) Ha a másik fél határidőben elfogadja az ajánlatot, a szerződés létrejön.<br>d) Ha a másik fél eltérő tartalommal fogadja el, az új ajánlatnak minősül.	b) Az ajánlati kötöttség idejét a felek közösen határozzák meg.	09_Szerzodesek
Az alábbiak közül melyikből nem származhat szerződéskötési kötelezettség?<br>a) Jogszabályból.<br>b) Versenyeztetési eljárásból.<br>c) Előszerződésből.<br>d) Mindháromból fentiből származhat.	d) Mindháromból fentiből származhat.	09_Szerzodesek
Melyik állítás igaz?<br>a) Az Általános Szerződési Feltételeket a felek előre, közösen határozzák meg.<br>b) A fogyasztó csak természetes személy lehet.<br>c) Távollévők között kötött szerződés létrejöhet két vállalkozás között is.<br>d) Fogyasztói szerződés esetén a fogyasztót 14 napon belül elállási jog illeti meg.	b) A fogyasztó csak természetes személy lehet.	09_Szerzodesek
Az érvénytelenségnek hányféle formája van a polgári jogban, és melyek ezek?<br>a) 3, éspedig a következők:<br>b) 2, éspedig a következők: semmisség, megtámadhatóság<br>c) 1, éspedig a következő:<br>d) A polgári jogban nem létezik az érvénytelenség fogalma.	b) 2, éspedig a következők: semmisség, megtámadhatóság	09_Szerzodesek
Az alábbiak közül melyik a célzott joghatás hibája?<br>a) A tévedés.<br>b) A megtévesztés.<br>c) A jó erkölcsbe ütközés.<br>d) A jogellenes fenyegetés.	c) A jó erkölcsbe ütközés.	09_Szerzodesek
Az alábbi esetek közül melyikben merül fel a szerződési akarat hibája?<br>a) A megtévesztéssel kötött szerződés.<br>b) Az uzsorás szerződés.<br>c) A jogszabályba ütköző szerződés.<br>d) A nem megfelelő formában megkötött szerződés.	a) A megtévesztéssel kötött szerződés.	09_Szerzodesek
Melyik állítás igaz?<br>a) A jogszabályba ütköző szerződés megtámadható.<br>b) A jogellenes fenyegetéssel kötött szerződés semmis.<br>c) Az uzsorás szerződés semmis.<br>d) Mindhárom fenti állítás hamis.	c) Az uzsorás szerződés semmis.	10_egyes_szerzodesek
Az alábbiak közül melyiknek a jogkövetkezménye a szerződés semmissége?<br>a) A feltűnő értékaránytalansággal kötött szerződés.<br>b) A megtévesztéssel kötött szerződés.<br>c) A jó erkölcsbe ütköző szerződés.<br>d) A jogellenes fenyegetéssel kötött szerződés.	c) A jó erkölcsbe ütköző szerződés.	10_egyes_szerzodesek
Melyik állítás hamis?<br>a) Érvénytelen szerződés alapján a teljesítés nem követelhető.<br>b) Hatálytalan szerződés alapján a teljesítés nem követelhető.<br>c) Érvénytelen szerződés alapján teljesített szolgáltatást nem lehet visszakövetelni.<br>d) Érvénytelen szerződés utóbb érvényessé válhat a felek akaratából.	c) Érvénytelen szerződés alapján teljesített szolgáltatást nem lehet visszakövetelni.	10_egyes_szerzodesek
Szerződésszegés esetén melyiket nem teheti meg a sérelmet szenvedett fél?<br>a) Továbbra is követelheti a teljesítést.<br>b) Fedezeti szerződést köthet és követelheti annak költségeit.<br>c) A nála levő, a másik fél tulajdonát képező dologból kielégítést kereshet.<br>d) A saját szolgáltatását visszatarthatja.	c) A nála levő, a másik fél tulajdonát képező dologból kielégítést kereshet.	10_egyes_szerzodesek
Az alábbiak közül melyik nem tartozik a szerződésszegés nevesített esetei közé?<br>a) A késedelem.<br>b) Az elállás.<br>c) A lehetetlenülés.<br>d) A teljesítés megtagadása.	b) Az elállás.	10_egyes_szerzodesek
Melyik állítás hamis?<br>a) Ha jogosult késedelembe esik a kárveszély átszáll rá.<br>b) Ha a hiba a teljesítés után keletkezett, szavatossági igény nem érvényesíthető.<br>c) Ha a teljesítés lehetetlenné válik, a szerződés megtámadható.<br>d) A kellékszavatossági igények 1 év alatt elévülnek.	c) Ha a teljesítés lehetetlenné válik, a szerződés megtámadható.	10_egyes_szerzodesek
Mennyi a kellékszavatossági igények elévülési ideje fogyasztói szerződés esetén?<br>a) 1 év<br>b) 2 év<br>c) 5 év<br>d) Fogyasztói szerződés esetén ezen igények nem évülnek el.	b) 2 év	10_egyes_szerzodesek
Az alábbiak közül melyiket nem választhatja a fogyasztó termékszavatossági igényként?<br>a) A kijavítást.<br>b) A kicserélést.<br>c) Az elállást.<br>d) Mindhármat választhatja.	c) Az elállást.	10_egyes_szerzodesek
Melyik állítás igaz a jótállásra vonatkozóan?<br>a) A jótállás minden szerződés esetén megilleti a szolgáltatás jogosultját.<br>b) A szavatosság és a jótállás ugyanazt jelenti.<br>c) A jótállási idő nem lehet hosszabb 5 évnél.<br>d) A jótállás lehet önkéntes vagy kötelező.	d) A jótállás lehet önkéntes vagy kötelező.	11_Adatvédelem
Az alábbi alanyváltozások közül melyik háromoldalú megállapodás?<br>a) A jogátruházás.<br>b) Az engedményezés.<br>c) A tartozásátvállalás.<br>d) Egyik sem.	c) A tartozásátvállalás.	11_Adatvédelem
Melyik állítás hamis?<br>a) A szerződés felmondása egyoldalú jognyilatkozat.<br>b) Az elállás a jövőre nézve szünteti meg a szerződést.<br>c) A szerződés felbontása a felek közös nyilatkozata.<br>d) A felek a szerződést bármikor megszüntethetik.	b) Az elállás a jövőre nézve szünteti meg a szerződést.	11_Adatvédelem
Az alábbiak közül melyik jog nem alapítható (szerezhető meg) bármikor?<br>a) Az eladási jog.<br>b) A vételi jog.<br>c) A visszavásárlási jog.<br>d) Az elővásárlási jog.	c) A visszavásárlási jog.	11_Adatvédelem
Melyik állítás hamis?<br>a) Az eladási jog jogosultja egyoldalú nyilatkozattal eladhatja a dolgot.<br>b) Az elővásárlási jog jogosultja egyoldalú nyilatkozattal megveheti a dolgot.<br>c) A vételi jog jogosultja egyoldalú nyilatkozattal megveheti a dolgot.<br>d) A visszavásárlási jog jogosultja egyoldalú nyilatkozattal megveheti a dolgot.	b) Az elővásárlási jog jogosultja egyoldalú nyilatkozattal megveheti a dolgot.	11_Adatvédelem
Az alábbiak közül melyiket nem kell az ingatlan-nyilvántartásba bejegyeztetni?<br>a) A tulajdonjog fenntartást.<br>b) A vételi jogot.<br>c) Az eladási jogot.<br>d) Mindhárom fentit be kell jegyeztetni.	d) Mindhárom fentit be kell jegyeztetni.	11_Adatvédelem
Az alábbiak közül melyiket nem kell az ingatlan-nyilvántartásba bejegyeztetni?<br>a) A tulajdonjog fenntartást.<br>b) A vételi jogot.<br>c) Az elbirtoklás megkezdődését.<br>d) Mindhárom fentit be kell jegyeztetni.	c) Az elbirtoklás megkezdődését.	12_Szellemi_alkotas
Melyik állítás igaz?<br>a) Az ajándékozás egyoldalú jognyilatkozat.<br>b) Ajándékozás történhet ellenérték fejében is.<br>c) Az ajándék egyes esetekben visszakövetelhető.<br>d) Az ajándékozásra a jogalap nélküli gazdagodás szabályait kell alkalmazni.	c) Az ajándék egyes esetekben visszakövetelhető.	12_Szellemi_alkotas
Melyik állítás hamis a vállalkozási szerződésre vonatkozóan?<br>a) A vállalkozási szerződés eredménykötelem.<br>b) A megrendelő a teljesítés előtt bármikor elállhat.<br>c) A vállalkozó a teljesítés előtt bármikor elállhat.<br>d) A vállalkozót törvényes zálogjog illeti meg.	c) A vállalkozó a teljesítés előtt bármikor elállhat.	12_Szellemi_alkotas
Az alábbiak közül melyik nem a vállalkozási szerződés altípusa?<br>a) A tervezési szerződés.<br>b) A fuvarozási szerződés.<br>c) A szállítmányozási szerződés.<br>d) A kivitelezési szerződés.	c) A szállítmányozási szerződés.	12_Szellemi_alkotas
Melyik állítás hamis?<br>a) A megbízási szerződés eredménykötelem.<br>b) A megbízó a szerződést felmondhatja.<br>c) A megbízott a szerződést felmondhatja.<br>d) A megbízottat törvényes zálogjog illeti meg.	a) A megbízási szerződés eredménykötelem.	12_Szellemi_alkotas
Az alábbiak közül melyik nem a megbízási szerződés altípusa?<br>a) A bizományi szerződés.<br>b) A szállítmányozási szerződés.<br>c) A közvetítői szerződés.<br>d) A fuvarozási szerződés.	d) A fuvarozási szerződés.	12_Szellemi_alkotas
Az alábbiak közül melyik nem minősül különleges adatnak?<br>a) Az érintett egészségi állapota.<br>b) Az érintett vagyoni helyzete.<br>c) Az érintett vallási meggyőződése.<br>d) Az érintett politikai véleménye.	b) Az érintett vagyoni helyzete.	12_Szellemi_alkotas
Az alábbi műveletek közül melyik nem minősül adatkezelésnek?<br>a) Az adatok gyűjtése.<br>b) Az adatok tárolása.<br>c) Az adatok lekérdezése.<br>d) Mind a három fenti művelet adatkezelésnek minősül.	d) Mind a három fenti művelet adatkezelésnek minősül.	12_Szellemi_alkotas
Az alábbi műveletek közül melyik minősül adatfeldolgozásnak?<br>a) Az adatok gyűjtése.<br>b) Az adatkezelő megbízásából végzett adatkezelési műveletek elvégzése.<br>c) Az adatok lekérdezése.<br>d) Mind a három fenti művelet adatfeldolgozásnak minősül.	b) Az adatkezelő megbízásából végzett adatkezelési műveletek elvégzése.	12_Szellemi_alkotas
Az alábbi 3 állítás (a,b,c) közül melyik hamis?<br>a) Személyes adatok kezeléséhez elég ha az érintett szóban hozzájárult.<br>b) Különleges adat csak törvényi előírás alapján kezelhető.<br>c) Bűnügyi személyes adatot csak állami vagy önkormányzati szerv kezelhet.<br>d) Mind a három fenti állítás igaz.	b) Különleges adat csak törvényi előírás alapján kezelhető.	12_Szellemi_alkotas
Az alábbi adatkezelők közül melyiknél nem kötelező adatvédelmi tisztviselő alkalmazása?<br>a) Állami feladatot ellátó adatkezelő szervezetnél.<br>b) Bíróságoknál.<br>c) Közfeladatot ellátó adatkezelő szervezetnél.<br>d) Mindhárom fenti esetben kötelező.	d) Mindhárom fenti esetben kötelező.	12_Szellemi_alkotas
Az alábbiak jogok közül melyikkel nem rendelkezik a személyes adatok érintettje?<br>a) A törléshez való joggal. <br>b) A helyesbítéshez való joggal.<br>c) Az előzetes tájékozódáshoz való joggal.<br>d) Mindhárom fenti joggal rendelkezik.	c) Az előzetes tájékozódáshoz való joggal.	12_Szellemi_alkotas
Az alábbi állítások közül melyik hamis?<br>a) A NAIH elnökét a köztársasági elnök nevezi ki 9 évre.<br>b) Az adatigénylésnek a közfeladatot ellátó szerv 15 napon belül köteles eleget tenni.<br>c) Az adatigénylés költségtérítése a kézbesítés költségét nem tartalmazhatja.<br>d) Adatigénylés benyújtása esetén a jogi képviselet nem kötelező.	c) Az adatigénylés költségtérítése a kézbesítés költségét nem tartalmazhatja.	12_Szellemi_alkotas
Az alábbiak közül melyik alkotás nem áll a szerzői jog védelme alatt?<br>a) Ötlet, eljárás.<br>b) Szoftver<br>c) Adatbázis<br>d) Térkép	a) Ötlet, eljárás.	12_Szellemi_alkotas
Mennyi ideig védi a szerzői jog a művet?<br>a) 50 évig.<br>b) A szerző élete végéig.<br>c) A szerző életében és halála után 70 évig.<br>d) 20 évig.	c) A szerző életében és halála után 70 évig.	12_Szellemi_alkotas
Melyik állítás hamis?<br>a) A felhasználási engedély korlátozható valamely területre.<br>b) A felhasználási engedély korlátozható megadott időtartamra.<br>c) A felhasználási engedély korlátozható valamely felhasználási módra.<br>d) A felhasználási engedély szóban is érvényes.	d) A felhasználási engedély szóban is érvényes.	12_Szellemi_alkotas
Mennyi ideig védi a szabadalmi oltalom a találmányt?<br>a) 10 évig.<br>b) 20 évig.<br>c) A szabadalmas élete végéig.<br>d) A szabadalmas életében és halála után 20 évig.	b) 20 évig.	12_Szellemi_alkotas